Id2,Total,NotHispanic,Hispanic,percHispanic,percHispanic
170310101001,421,392,29,6.90,7
170310101002,1525,1385,140,9.20,9
170310101003,2243,1956,287,12.80,13
170310102011,1716,1135,581,33.90,34
170310102012,4592,3637,955,20.80,21
170310102013,775,740,35,4.50,5
170310102021,1427,974,453,31.70,32
170310102022,1075,870,205,19.10,19
170310103001,998,647,351,35.20,35
170310103002,2200,1863,337,15.30,15
170310103003,1316,1287,29,2.20,2
170310103004,1699,1452,247,14.50,15
170310104001,1632,1462,170,10.40,10
170310104002,858,713,145,16.90,17
170310104003,2240,2101,139,6.20,6
170310105011,1098,986,112,10.20,10
170310105012,1669,1638,31,1.90,2
170310105013,1064,1016,48,4.50,5
170310105021,1222,917,305,25.00,25
170310105022,2468,2195,273,11.10,11
170310105031,1537,1228,309,20.10,20
170310105032,691,626,65,9.40,9
170310106001,2724,1875,849,31.20,31
170310106002,844,802,42,5.00,5
170310106003,1455,1249,206,14.20,14
170310106004,1490,872,618,41.50,42
170310107011,2105,1059,1046,49.70,50
170310107012,1841,1233,608,33.00,33
170310107021,1499,814,685,45.70,46
170310107022,1492,700,792,53.10,53
170310107023,1184,571,613,51.80,52
170310107024,1099,535,564,51.30,51
170310201001,2545,2102,443,17.40,17
170310201002,1445,1399,46,3.20,3
170310202001,1370,1238,132,9.60,10
170310202002,1460,1411,49,3.40,3
170310202003,1689,1361,328,19.40,19
170310202004,1736,1663,73,4.20,4
170310203011,1619,1424,195,12.00,12
170310203012,1360,1273,87,6.40,6
170310203013,2260,2190,70,3.10,3
170310203021,1013,799,214,21.10,21
170310203022,1121,827,294,26.20,26
170310203023,2517,2141,376,14.90,15
170310204001,693,606,87,12.60,13
170310204002,1693,1374,319,18.80,19
170310204003,1908,1355,553,29.00,29
170310205001,2561,1882,679,26.50,27
170310205002,573,314,259,45.20,45
170310205003,1526,1134,392,25.70,26
170310205004,1344,754,590,43.90,44
170310206011,2177,1660,517,23.70,24
170310206012,3127,2819,308,9.80,10
170310206013,1393,1235,158,11.30,11
170310206021,1003,677,326,32.50,33
170310206022,1057,896,161,15.20,15
170310206023,926,770,156,16.80,17
170310206024,1116,698,418,37.50,38
170310207011,818,691,127,15.50,16
170310207012,1075,934,141,13.10,13
170310207021,2372,2232,140,5.90,6
170310207022,3078,2278,800,26.00,26
170310207023,1870,1820,50,2.70,3
170310207024,912,804,108,11.80,12
170310208011,1470,586,884,60.10,60
170310208012,943,852,91,9.70,10
170310208013,769,597,172,22.40,22
170310208014,1330,1108,222,16.70,17
170310208021,1480,1029,451,30.50,31
170310208022,2285,1900,385,16.80,17
170310208023,2364,1917,447,18.90,19
170310208024,1813,1688,125,6.90,7
170310209011,2245,1961,284,12.70,13
170310209012,683,497,186,27.20,27
170310209013,2085,1272,813,39.00,39
170310209021,2261,1964,297,13.10,13
170310209022,1934,1799,135,7.00,7
170310301011,993,633,360,36.30,36
170310301012,318,251,67,21.10,21
170310301013,1143,898,245,21.40,21
170310301014,1273,1134,139,10.90,11
170310301021,994,841,153,15.40,15
170310301022,835,715,120,14.40,14
170310301023,1127,996,131,11.60,12
170310301031,813,761,52,6.40,6
170310301032,1425,1118,307,21.50,22
170310301041,2928,2704,224,7.70,8
170310301042,760,689,71,9.30,9
170310302001,1366,1282,84,6.10,6
170310302002,1045,1002,43,4.10,4
170310302003,1018,918,100,9.80,10
170310302004,1845,1216,629,34.10,34
170310303001,1450,951,499,34.40,34
170310303002,1599,826,773,48.30,48
170310304001,1536,1010,526,34.20,34
170310304002,1147,786,361,31.50,32
170310305001,1407,1081,326,23.20,23
170310305002,1994,1312,682,34.20,34
170310305003,1429,1027,402,28.10,28
170310305004,1439,1105,334,23.20,23
170310306011,772,754,18,2.30,2
170310306012,1035,671,364,35.20,35
170310306013,1731,1568,163,9.40,9
170310306031,1038,985,53,5.10,5
170310306032,1010,934,76,7.50,8
170310306041,1102,1076,26,2.40,2
170310306042,1143,1091,52,4.50,5
170310306043,716,703,13,1.80,2
170310307011,1734,1649,85,4.90,5
170310307021,849,828,21,2.50,3
170310307022,611,604,7,1.10,1
170310307031,756,741,15,2.00,2
170310307032,544,498,46,8.50,9
170310307033,1279,1190,89,7.00,7
170310307061,2157,1977,180,8.30,8
170310307062,1303,1198,105,8.10,8
170310308001,1191,1048,143,12.00,12
170310308002,1074,999,75,7.00,7
170310308003,840,798,42,5.00,5
170310308004,1300,1016,284,21.80,22
170310309001,374,351,23,6.10,6
170310309002,1017,776,241,23.70,24
170310309003,1055,902,153,14.50,15
170310309004,761,656,105,13.80,14
170310310001,1179,908,271,23.00,23
170310310002,996,852,144,14.50,15
170310310003,1347,1250,97,7.20,7
170310311001,1944,1848,96,4.90,5
170310311002,777,664,113,14.50,15
170310311003,1415,942,473,33.40,33
170310312001,1242,1155,87,7.00,7
170310312002,1200,1151,49,4.10,4
170310312003,1055,786,269,25.50,26
170310312004,1363,1155,208,15.30,15
170310313001,1242,1152,90,7.20,7
170310313002,1305,1168,137,10.50,11
170310313003,596,596,0,0.00,0
170310313004,2427,2086,341,14.10,14
170310313005,1973,1661,312,15.80,16
170310314001,1564,1383,181,11.60,12
170310314002,832,816,16,1.90,2
170310314003,791,761,30,3.80,4
170310314004,136,129,7,5.10,5
170310314005,1161,942,219,18.90,19
170310314006,776,717,59,7.60,8
170310315011,844,777,67,7.90,8
170310315012,1365,1305,60,4.40,4
170310315013,1221,1151,70,5.70,6
170310315021,1559,1073,486,31.20,31
170310315022,1112,1031,81,7.30,7
170310315023,1715,1548,167,9.70,10
170310317001,2108,1438,670,31.80,32
170310317002,1749,1628,121,6.90,7
170310317003,1566,1371,195,12.50,13
170310317004,1102,1102,0,0.00,0
170310318001,1717,1377,340,19.80,20
170310319001,1211,1078,133,11.00,11
170310319002,1144,1051,93,8.10,8
170310321001,1593,1502,91,5.70,6
170310321002,1607,1461,146,9.10,9
170310321003,1544,1301,243,15.70,16
170310321004,1069,919,150,14.00,14
170310321005,954,809,145,15.20,15
170310401001,1328,1237,91,6.90,7
170310401002,1647,1075,572,34.70,35
170310401003,1023,961,62,6.10,6
170310402011,1022,732,290,28.40,28
170310402012,1580,1403,177,11.20,11
170310402013,1350,1237,113,8.40,8
170310402014,2243,1753,490,21.80,22
170310402021,914,904,10,1.10,1
170310402022,2795,2271,524,18.70,19
170310402023,1305,1073,232,17.80,18
170310402024,1677,1397,280,16.70,17
170310403001,1020,919,101,9.90,10
170310403002,824,764,60,7.30,7
170310403003,812,699,113,13.90,14
170310404011,698,550,148,21.20,21
170310404012,485,423,62,12.80,13
170310404013,663,470,193,29.10,29
170310404014,990,850,140,14.10,14
170310404021,586,586,0,0.00,0
170310404022,881,543,338,38.40,38
170310404023,1168,872,296,25.30,25
170310404024,515,515,0,0.00,0
170310404025,1551,1415,136,8.80,9
170310406001,757,666,91,12.00,12
170310406002,882,863,19,2.20,2
170310406003,1045,785,260,24.90,25
170310407001,957,742,215,22.50,23
170310407002,854,686,168,19.70,20
170310407003,781,472,309,39.60,40
170310407004,761,575,186,24.40,24
170310408001,984,909,75,7.60,8
170310408002,831,752,79,9.50,10
170310409001,1443,1290,153,10.60,11
170310409002,675,636,39,5.80,6
170310501001,834,630,204,24.50,25
170310501002,1572,1404,168,10.70,11
170310502001,1136,901,235,20.70,21
170310502002,2121,1616,505,23.80,24
170310502003,1863,1490,373,20.00,20
170310503001,995,798,197,19.80,20
170310503002,805,619,186,23.10,23
170310503003,766,614,152,19.80,20
170310505001,860,846,14,1.60,2
170310505002,1589,1448,141,8.90,9
170310505003,585,564,21,3.60,4
170310505004,1116,910,206,18.50,19
170310505005,1215,1025,190,15.60,16
170310506001,1269,1159,110,8.70,9
170310506002,1145,1015,130,11.40,11
170310507001,1753,1671,82,4.70,5
170310508001,1427,1323,104,7.30,7
170310509001,1660,1547,113,6.80,7
170310510001,1610,1355,255,15.80,16
170310511001,1526,1287,239,15.70,16
170310512001,726,721,5,0.70,1
170310512002,836,671,165,19.70,20
170310513001,1553,1332,221,14.20,14
170310513002,1400,1292,108,7.70,8
170310514001,1571,1444,127,8.10,8
170310514002,603,447,156,25.90,26
170310601001,723,704,19,2.60,3
170310601002,1101,1033,68,6.20,6
170310601003,772,647,125,16.20,16
170310602001,892,785,107,12.00,12
170310602002,1234,1037,197,16.00,16
170310603001,1834,1775,59,3.20,3
170310603002,1342,1264,78,5.80,6
170310604001,1956,1605,351,17.90,18
170310604002,1125,1106,19,1.70,2
170310604003,922,865,57,6.20,6
170310605001,1235,1091,144,11.70,12
170310608001,1532,1439,93,6.10,6
170310608002,0,0,0,#DIV/0!,#DIV/0!
170310608003,3308,3191,117,3.50,4
170310609001,756,676,80,10.60,11
170310609002,0,0,0,#DIV/0!,#DIV/0!
170310609003,1671,1424,247,14.80,15
170310609004,3564,3059,505,14.20,14
170310609005,767,702,65,8.50,9
170310610001,1716,1452,264,15.40,15
170310611001,1309,1267,42,3.20,3
170310612001,2235,2133,102,4.60,5
170310615001,1859,1740,119,6.40,6
170310618001,1130,1006,124,11.00,11
170310619011,623,530,93,14.90,15
170310619012,1040,975,65,6.30,6
170310619013,793,753,40,5.00,5
170310619014,1329,1074,255,19.20,19
170310619021,1042,1028,14,1.30,1
170310619022,1570,1452,118,7.50,8
170310619023,1433,1349,84,5.90,6
170310619024,0,0,0,#DIV/0!,#DIV/0!
170310620001,1969,1863,106,5.40,5
170310620002,928,928,0,0.00,0
170310621001,959,916,43,4.50,5
170310621002,1102,1010,92,8.30,8
170310621003,1311,1221,90,6.90,7
170310622001,1593,1483,110,6.90,7
170310622002,1394,1344,50,3.60,4
170310623001,1716,1645,71,4.10,4
170310624001,1622,1537,85,5.20,5
170310625001,1342,1282,60,4.50,5
170310626001,2281,1988,293,12.80,13
170310627001,782,656,126,16.10,16
170310627002,835,805,30,3.60,4
170310627003,1140,1121,19,1.70,2
170310628001,1195,1006,189,15.80,16
170310628002,1168,1101,67,5.70,6
170310628003,1429,1359,70,4.90,5
170310629001,1415,1408,7,0.50,1
170310629002,1146,1074,72,6.30,6
170310629003,1615,1554,61,3.80,4
170310630001,1324,1197,127,9.60,10
170310630002,1088,979,109,10.00,10
170310630003,643,591,52,8.10,8
170310631001,1344,1193,151,11.20,11
170310631002,1055,1020,35,3.30,3
170310632001,1012,1012,0,0.00,0
170310632002,657,657,0,0.00,0
170310632003,911,861,50,5.50,6
170310632004,1395,1375,20,1.40,1
170310632005,714,668,46,6.40,6
170310632006,1891,1832,59,3.10,3
170310633011,1100,973,127,11.50,12
170310633012,704,658,46,6.50,7
170310633013,822,822,0,0.00,0
170310633021,1717,1692,25,1.50,2
170310633022,1010,932,78,7.70,8
170310633023,489,440,49,10.00,10
170310633024,970,942,28,2.90,3
170310633031,492,457,35,7.10,7
170310633032,665,650,15,2.30,2
170310634001,1143,1059,84,7.30,7
170310634002,1015,933,82,8.10,8
170310701011,1363,1340,23,1.70,2
170310701012,1456,1442,14,1.00,1
170310701013,1169,1169,0,0.00,0
170310701021,995,840,155,15.60,16
170310701022,763,763,0,0.00,0
170310701023,898,726,172,19.20,19
170310701031,1004,969,35,3.50,4
170310701032,675,587,88,13.00,13
170310702001,2109,1914,195,9.20,9
170310702002,1013,962,51,5.00,5
170310702003,815,789,26,3.20,3
170310703001,2120,2014,106,5.00,5
170310703002,1263,1229,34,2.70,3
170310704001,1353,1109,244,18.00,18
170310704002,936,895,41,4.40,4
170310704003,1151,1150,1,0.10,0
170310705001,872,767,105,12.00,12
170310705002,1124,1039,85,7.60,8
170310705003,1026,986,40,3.90,4
170310706001,1832,1531,301,16.40,16
170310706002,1251,1212,39,3.10,3
170310707001,2878,2484,394,13.70,14
170310707002,1105,838,267,24.20,24
170310710001,2377,2155,222,9.30,9
170310710002,1900,1704,196,10.30,10
170310711001,1503,1471,32,2.10,2
170310711002,1429,1361,68,4.80,5
170310712001,940,785,155,16.50,17
170310712002,1076,1015,61,5.70,6
170310713001,1465,1378,87,5.90,6
170310713002,1949,1923,26,1.30,1
170310714001,632,507,125,19.80,20
170310714002,1817,1754,63,3.50,4
170310714003,1219,1180,39,3.20,3
170310714004,689,675,14,2.00,2
170310715001,873,853,20,2.30,2
170310715002,1201,1184,17,1.40,1
170310715003,1319,1185,134,10.20,10
170310715004,1107,1013,94,8.50,9
170310715005,496,467,29,5.80,6
170310715006,714,701,13,1.80,2
170310716001,1715,1666,49,2.90,3
170310717001,885,744,141,15.90,16
170310717002,928,919,9,1.00,1
170310718001,2065,1978,87,4.20,4
170310718002,605,558,47,7.80,8
170310801001,997,997,0,0.00,0
170310801002,1461,1371,90,6.20,6
170310801003,877,812,65,7.40,7
170310801004,911,911,0,0.00,0
170310801005,878,729,149,17.00,17
170310801006,895,878,17,1.90,2
170310801007,638,638,0,0.00,0
170310802011,1540,1527,13,0.80,1
170310802012,1332,1319,13,1.00,1
170310802013,363,363,0,0.00,0
170310802021,534,523,11,2.10,2
170310802022,906,897,9,1.00,1
170310802023,2093,2031,62,3.00,3
170310803001,584,534,50,8.60,9
170310803002,1673,1582,91,5.40,5
170310803003,915,915,0,0.00,0
170310803004,1308,1301,7,0.50,1
170310804001,2754,2677,77,2.80,3
170310804002,659,614,45,6.80,7
170310804003,1494,1494,0,0.00,0
170310810001,332,318,14,4.20,4
170310810002,1157,1074,83,7.20,7
170310810003,946,946,0,0.00,0
170310810004,1139,1075,64,5.60,6
170310810005,2473,2242,231,9.30,9
170310810006,1380,1292,88,6.40,6
170310811001,1170,1151,19,1.60,2
170310811002,1363,1202,161,11.80,12
170310811003,1124,1035,89,7.90,8
170310812011,1028,1028,0,0.00,0
170310812012,1899,1634,265,14.00,14
170310812013,1625,1554,71,4.40,4
170310812021,464,435,29,6.30,6
170310812022,742,559,183,24.70,25
170310812023,1110,1040,70,6.30,6
170310812024,905,896,9,1.00,1
170310813001,706,656,50,7.10,7
170310813002,507,493,14,2.80,3
170310813003,807,675,132,16.40,16
170310813004,1789,1760,29,1.60,2
170310813005,489,489,0,0.00,0
170310813006,755,755,0,0.00,0
170310814011,1031,1014,17,1.60,2
170310814012,1485,1454,31,2.10,2
170310814021,2103,2003,100,4.80,5
170310814022,1493,1472,21,1.40,1
170310814023,793,705,88,11.10,11
170310814031,3006,2726,280,9.30,9
170310814032,1294,1097,197,15.20,15
170310814033,2704,2657,47,1.70,2
170310815001,1475,1454,21,1.40,1
170310815002,1375,1336,39,2.80,3
170310815003,1550,1468,82,5.30,5
170310816001,2178,2072,106,4.90,5
170310816002,999,938,61,6.10,6
170310817001,975,969,6,0.60,1
170310817002,2632,2024,608,23.10,23
170310818001,3435,3301,134,3.90,4
170310818002,2689,2605,84,3.10,3
170310818003,1364,1315,49,3.60,4
170310819001,1152,1115,37,3.20,3
170310901001,1040,932,108,10.40,10
170310901002,1097,908,189,17.20,17
170310901003,622,580,42,6.80,7
170310901004,503,485,18,3.60,4
170310902001,1105,829,276,25.00,25
170310902002,1202,1100,102,8.50,9
170310902003,1714,1663,51,3.00,3
170310902004,1841,1815,26,1.40,1
170310902005,544,543,1,0.20,0
170310903001,1325,1281,44,3.30,3
170311001001,846,780,66,7.80,8
170311001002,1724,1325,399,23.10,23
170311001003,940,940,0,0.00,0
170311001004,785,545,240,30.60,31
170311001005,1371,1321,50,3.60,4
170311002001,1225,968,257,21.00,21
170311002002,571,518,53,9.30,9
170311002003,1488,1451,37,2.50,3
170311002004,868,735,133,15.30,15
170311002005,763,641,122,16.00,16
170311002006,1109,876,233,21.00,21
170311002007,581,558,23,4.00,4
170311003001,850,809,41,4.80,5
170311003002,1061,906,155,14.60,15
170311003003,740,625,115,15.50,16
170311003004,1314,960,354,26.90,27
170311003005,861,782,79,9.20,9
170311003006,1203,1168,35,2.90,3
170311004001,823,823,0,0.00,0
170311004002,954,838,116,12.20,12
170311004003,1250,976,274,21.90,22
170311005001,870,856,14,1.60,2
170311005002,775,775,0,0.00,0
170311005003,512,409,103,20.10,20
170311005004,1102,917,185,16.80,17
170311005005,1897,1894,3,0.20,0
170311006001,1090,937,153,14.00,14
170311006002,1445,1269,176,12.20,12
170311006003,1085,896,189,17.40,17
170311006004,1634,1281,353,21.60,22
170311007001,844,701,143,16.90,17
170311007002,750,653,97,12.90,13
170311007003,1121,966,155,13.80,14
170311007004,1047,921,126,12.00,12
170311007005,987,958,29,2.90,3
170311101001,1805,1322,483,26.80,27
170311101002,1334,1126,208,15.60,16
170311101003,448,287,161,35.90,36
170311101004,1000,689,311,31.10,31
170311101005,1336,1283,53,4.00,4
170311102001,1631,1452,179,11.00,11
170311102002,1386,1221,165,11.90,12
170311103001,582,507,75,12.90,13
170311103002,1319,969,350,26.50,27
170311103003,946,769,177,18.70,19
170311103004,1443,1230,213,14.80,15
170311103005,1024,854,170,16.60,17
170311104001,1903,1470,433,22.80,23
170311104002,1694,1379,315,18.60,19
170311104003,842,754,88,10.50,11
170311105011,1053,810,243,23.10,23
170311105012,606,529,77,12.70,13
170311105013,2148,1681,467,21.70,22
170311105014,396,182,214,54.00,54
170311105015,433,404,29,6.70,7
170311105021,1418,1227,191,13.50,14
170311105022,2228,1456,772,34.60,35
170311201001,1452,1402,50,3.40,3
170311201002,944,913,31,3.30,3
170311201003,542,542,0,0.00,0
170311201004,1055,963,92,8.70,9
170311202001,1601,1533,68,4.20,4
170311202002,666,653,13,2.00,2
170311202003,1258,984,274,21.80,22
170311202004,1027,880,147,14.30,14
170311203001,1016,967,49,4.80,5
170311203002,1339,1057,282,21.10,21
170311203003,1633,1578,55,3.40,3
170311203004,813,554,259,31.90,32
170311203005,552,525,27,4.90,5
170311203006,826,801,25,3.00,3
170311204001,1050,1037,13,1.20,1
170311204002,1152,810,342,29.70,30
170311204003,1552,922,630,40.60,41
170311301001,958,824,134,14.00,14
170311301002,2393,2118,275,11.50,12
170311301003,1807,1569,238,13.20,13
170311302001,1598,1290,308,19.30,19
170311303001,552,552,0,0.00,0
170311303002,1027,798,229,22.30,22
170311303003,1684,1255,429,25.50,26
170311303004,1997,1591,406,20.30,20
170311401001,1935,692,1243,64.20,64
170311401002,2144,1072,1072,50.00,50
170311402001,2318,1451,867,37.40,37
170311402002,1306,737,569,43.60,44
170311402003,2271,748,1523,67.10,67
170311403011,1080,179,901,83.40,83
170311403012,1668,732,936,56.10,56
170311403021,1153,467,686,59.50,60
170311403022,1517,802,715,47.10,47
170311403023,1802,1305,497,27.60,28
170311404001,1432,900,532,37.20,37
170311404002,1672,1300,372,22.20,22
170311404003,1110,787,323,29.10,29
170311404004,1254,954,300,23.90,24
170311404005,1718,1281,437,25.40,25
170311405001,1184,779,405,34.20,34
170311405002,1685,455,1230,73.00,73
170311405003,1252,831,421,33.60,34
170311406011,2969,1089,1880,63.30,63
170311406021,1152,333,819,71.10,71
170311406022,2093,542,1551,74.10,74
170311406023,1236,388,848,68.60,69
170311406024,1133,438,695,61.30,61
170311407011,1254,663,591,47.10,47
170311407012,1131,513,618,54.60,55
170311407021,1852,603,1249,67.40,67
170311407022,1463,538,925,63.20,63
170311407023,1528,398,1130,74.00,74
170311407024,1409,713,696,49.40,49
170311408001,1047,555,492,47.00,47
170311408002,730,608,122,16.70,17
170311408003,1241,1028,213,17.20,17
170311408004,1235,690,545,44.10,44
170311408005,2956,1467,1489,50.40,50
170311502001,1169,967,202,17.30,17
170311502002,1665,1369,296,17.80,18
170311502003,1637,1228,409,25.00,25
170311502004,1589,1290,299,18.80,19
170311502005,1761,847,914,51.90,52
170311503001,1032,806,226,21.90,22
170311503002,1255,876,379,30.20,30
170311503003,1222,556,666,54.50,55
170311503004,847,571,276,32.60,33
170311503005,788,627,161,20.40,20
170311503006,1042,742,300,28.80,29
170311503007,1340,922,418,31.20,31
170311504011,1496,929,567,37.90,38
170311504012,1582,1041,541,34.20,34
170311504013,1162,921,241,20.70,21
170311504014,565,544,21,3.70,4
170311504021,570,345,225,39.50,40
170311504022,1196,509,687,57.40,57
170311504023,1929,1082,847,43.90,44
170311505011,1272,981,291,22.90,23
170311505012,902,769,133,14.70,15
170311505013,1569,903,666,42.40,42
170311505021,1418,1096,322,22.70,23
170311505022,1167,693,474,40.60,41
170311505023,1705,775,930,54.50,55
170311506001,1250,404,846,67.70,68
170311506002,687,592,95,13.80,14
170311506003,947,568,379,40.00,40
170311506004,984,711,273,27.70,28
170311507001,1091,686,405,37.10,37
170311507002,1413,777,636,45.00,45
170311507003,937,326,611,65.20,65
170311507004,1180,837,343,29.10,29
170311508001,992,512,480,48.40,48
170311508002,1029,425,604,58.70,59
170311508003,1248,588,660,52.90,53
170311508004,1581,729,852,53.90,54
170311508005,601,310,291,48.40,48
170311510011,1906,481,1425,74.80,75
170311510012,632,348,284,44.90,45
170311510021,1117,287,830,74.30,74
170311510022,1251,466,785,62.70,63
170311510023,1736,570,1166,67.20,67
170311510024,581,329,252,43.40,43
170311511001,1651,830,821,49.70,50
170311511002,1383,590,793,57.30,57
170311511003,983,642,341,34.70,35
170311511004,1374,611,763,55.50,56
170311512001,1152,622,530,46.00,46
170311512002,1594,941,653,41.00,41
170311512003,934,841,93,10.00,10
170311601001,1558,1388,170,10.90,11
170311601002,1068,485,583,54.60,55
170311602001,605,548,57,9.40,9
170311602002,959,516,443,46.20,46
170311602003,625,557,68,10.90,11
170311602004,1633,1096,537,32.90,33
170311603001,1734,1469,265,15.30,15
170311603002,1031,704,327,31.70,32
170311603003,1112,770,342,30.80,31
170311604001,2484,1208,1276,51.40,51
170311604002,1518,1142,376,24.80,25
170311604003,1088,478,610,56.10,56
170311605011,2286,837,1449,63.40,63
170311605012,2212,493,1719,77.70,78
170311605021,896,250,646,72.10,72
170311605022,2064,844,1220,59.10,59
170311605023,1608,431,1177,73.20,73
170311606011,1441,657,784,54.40,54
170311606012,919,272,647,70.40,70
170311606013,1639,683,956,58.30,58
170311606021,1310,709,601,45.90,46
170311606022,1083,358,725,66.90,67
170311606023,1590,997,593,37.30,37
170311607001,857,809,48,5.60,6
170311607002,1212,705,507,41.80,42
170311607003,1696,1126,570,33.60,34
170311607004,1154,544,610,52.90,53
170311607005,1089,342,747,68.60,69
170311608001,1065,372,693,65.10,65
170311608002,1339,593,746,55.70,56
170311608003,1149,326,823,71.60,72
170311608004,671,431,240,35.80,36
170311608005,1164,587,577,49.60,50
170311609001,1347,998,349,25.90,26
170311609002,925,689,236,25.50,26
170311610001,838,537,301,35.90,36
170311610002,888,608,280,31.50,32
170311611001,988,812,176,17.80,18
170311611002,1038,823,215,20.70,21
170311612001,1106,531,575,52.00,52
170311612002,1558,766,792,50.80,51
170311613001,782,310,472,60.40,60
170311613002,1081,421,660,61.10,61
170311613003,719,172,547,76.10,76
170311613004,1361,538,823,60.50,61
170311701001,1871,1649,222,11.90,12
170311702001,1488,1011,477,32.10,32
170311702002,1359,762,597,43.90,44
170311702003,1519,932,587,38.60,39
170311703001,741,524,217,29.30,29
170311703002,881,783,98,11.10,11
170311703003,846,459,387,45.70,46
170311703004,1165,732,433,37.20,37
170311703005,1285,1148,137,10.70,11
170311704001,950,805,145,15.30,15
170311704002,1170,831,339,29.00,29
170311704003,919,684,235,25.60,26
170311704004,681,640,41,6.00,6
170311705001,1643,1299,344,20.90,21
170311705002,787,711,76,9.70,10
170311705003,1348,1012,336,24.90,25
170311705004,1110,883,227,20.50,21
170311706001,1013,876,137,13.50,14
170311706002,1761,1383,378,21.50,22
170311707001,963,716,247,25.60,26
170311707002,806,731,75,9.30,9
170311707003,1062,821,241,22.70,23
170311708001,1207,944,263,21.80,22
170311708002,1159,870,289,24.90,25
170311708003,1384,1107,277,20.00,20
170311709001,1729,1243,486,28.10,28
170311710001,1906,1132,774,40.60,41
170311710002,1295,883,412,31.80,32
170311710003,998,797,201,20.10,20
170311710004,1129,874,255,22.60,23
170311710005,1336,1078,258,19.30,19
170311710006,1285,833,452,35.20,35
170311711001,1703,923,780,45.80,46
170311711002,1339,827,512,38.20,38
170311711003,1215,895,320,26.30,26
170311801001,1240,610,630,50.80,51
170311801002,746,388,358,48.00,48
170311801003,1398,692,706,50.50,51
170311801004,820,551,269,32.80,33
170311801005,1714,670,1044,60.90,61
170311901001,2720,760,1960,72.10,72
170311902001,1424,141,1283,90.10,90
170311902002,1726,371,1355,78.50,79
170311902003,1511,287,1224,81.00,81
170311902004,1033,399,634,61.40,61
170311903001,1176,568,608,51.70,52
170311903002,1569,605,964,61.40,61
170311903003,1361,483,878,64.50,65
170311903004,1339,213,1126,84.10,84
170311904011,1548,758,790,51.00,51
170311904012,2635,893,1742,66.10,66
170311904021,1939,772,1167,60.20,60
170311904022,2703,681,2022,74.80,75
170311906011,1008,298,710,70.40,70
170311906012,1062,187,875,82.40,82
170311906013,2707,293,2414,89.20,89
170311906021,1832,235,1597,87.20,87
170311906022,1912,655,1257,65.70,66
170311906023,1521,263,1258,82.70,83
170311907011,1801,343,1458,81.00,81
170311907012,1271,275,996,78.40,78
170311907021,845,174,671,79.40,79
170311907022,2267,514,1753,77.30,77
170311907023,1978,389,1589,80.30,80
170311908001,1205,357,848,70.40,70
170311908002,808,175,633,78.30,78
170311908003,1637,123,1514,92.50,93
170311908004,1693,166,1527,90.20,90
170311908005,1538,182,1356,88.20,88
170311909001,1864,297,1567,84.10,84
170311910001,1306,78,1228,94.00,94
170311910002,1595,137,1458,91.40,91
170311911001,1162,107,1055,90.80,91
170311911002,897,55,842,93.90,94
170311911003,1381,51,1330,96.30,96
170311911004,1462,75,1387,94.90,95
170311911005,2210,196,2014,91.10,91
170311911006,824,196,628,76.20,76
170311912001,2916,342,2574,88.30,88
170311912002,1059,59,1000,94.40,94
170311913011,2980,458,2522,84.60,85
170311913012,1500,311,1189,79.30,79
170311913013,1461,185,1276,87.30,87
170311913021,2290,247,2043,89.20,89
170311913022,2798,223,2575,92.00,92
170312001001,963,228,735,76.30,76
170312001002,1438,205,1233,85.70,86
170312001003,2202,586,1616,73.40,73
170312002001,1035,219,816,78.80,79
170312002002,1530,95,1435,93.80,94
170312002003,883,82,801,90.70,91
170312002004,1520,189,1331,87.60,88
170312003001,1331,110,1221,91.70,92
170312003002,1070,70,1000,93.50,94
170312004011,954,121,833,87.30,87
170312004012,2860,81,2779,97.20,97
170312004021,825,105,720,87.30,87
170312004022,1268,66,1202,94.80,95
170312004023,1940,98,1842,94.90,95
170312101001,1381,1040,341,24.70,25
170312101002,1129,496,633,56.10,56
170312101003,937,653,284,30.30,30
170312104001,2062,744,1318,63.90,64
170312104002,1066,217,849,79.60,80
170312105011,1281,215,1066,83.20,83
170312105012,3288,1317,1971,59.90,60
170312105021,1879,604,1275,67.90,68
170312105022,1964,840,1124,57.20,57
170312105023,1066,257,809,75.90,76
170312106011,645,123,522,80.90,81
170312106012,986,265,721,73.10,73
170312106013,1435,511,924,64.40,64
170312106021,1342,526,816,60.80,61
170312106022,1027,240,787,76.60,77
170312106023,1757,548,1209,68.80,69
170312107001,908,311,597,65.70,66
170312107002,1345,656,689,51.20,51
170312107003,1725,823,902,52.30,52
170312108001,1028,480,548,53.30,53
170312109001,2054,782,1272,61.90,62
170312109002,1169,568,601,51.40,51
170312203001,1382,823,559,40.40,40
170312203002,1027,755,272,26.50,27
170312204001,1089,692,397,36.50,37
170312204002,1476,903,573,38.80,39
170312205001,949,815,134,14.10,14
170312205002,814,564,250,30.70,31
170312205003,919,569,350,38.10,38
170312206011,680,554,126,18.50,19
170312206012,916,312,604,65.90,66
170312206021,329,293,36,10.90,11
170312206022,658,502,156,23.70,24
170312206023,1102,578,524,47.50,48
170312206024,1898,1155,743,39.10,39
170312206025,703,516,187,26.60,27
170312207011,924,382,542,58.70,59
170312207012,1061,363,698,65.80,66
170312207013,1474,498,976,66.20,66
170312207021,1800,192,1608,89.30,89
170312207022,810,366,444,54.80,55
170312207023,672,296,376,56.00,56
170312207024,1144,255,889,77.70,78
170312209011,1056,367,689,65.20,65
170312209012,899,343,556,61.80,62
170312209013,1342,89,1253,93.40,93
170312209021,1303,275,1028,78.90,79
170312209022,2022,413,1609,79.60,80
170312210001,1565,386,1179,75.30,75
170312210002,1689,387,1302,77.10,77
170312211001,2003,1263,740,36.90,37
170312211002,1713,810,903,52.70,53
170312211003,1094,709,385,35.20,35
170312212001,1331,651,680,51.10,51
170312212002,1734,1098,636,36.70,37
170312213001,1394,602,792,56.80,57
170312213002,787,552,235,29.90,30
170312213003,581,416,165,28.40,28
170312214001,837,269,568,67.90,68
170312214002,761,543,218,28.60,29
170312214003,1201,537,664,55.30,55
170312215001,993,568,425,42.80,43
170312215002,1581,749,832,52.60,53
170312216001,1319,1177,142,10.80,11
170312216002,1799,1216,583,32.40,32
170312222001,860,732,128,14.90,15
170312222002,1104,1098,6,0.50,1
170312225001,1424,475,949,66.60,67
170312226001,1554,872,682,43.90,44
170312227001,1131,368,763,67.50,68
170312227002,1529,541,988,64.60,65
170312228001,1014,209,805,79.40,79
170312229001,878,242,636,72.40,72
170312301001,1646,832,814,49.50,50
170312302001,1972,500,1472,74.60,75
170312303001,1170,139,1031,88.10,88
170312304001,1499,110,1389,92.70,93
170312304002,1167,107,1060,90.80,91
170312305001,2545,294,2251,88.40,88
170312305002,1165,212,953,81.80,82
170312306001,722,145,577,79.90,80
170312306002,1558,1210,348,22.30,22
170312306003,813,169,644,79.20,79
170312306004,1519,298,1221,80.40,80
170312306005,1381,941,440,31.90,32
170312306006,940,453,487,51.80,52
170312307001,1379,79,1300,94.30,94
170312307002,1212,146,1066,88.00,88
170312307003,1436,396,1040,72.40,72
170312307004,1150,92,1058,92.00,92
170312308001,1195,223,972,81.30,81
170312309001,1755,863,892,50.80,51
170312309002,1806,948,858,47.50,48
170312309003,1594,500,1094,68.60,69
170312311001,1227,848,379,30.90,31
170312312001,986,182,804,81.50,82
170312312002,1644,1453,191,11.60,12
170312312003,450,361,89,19.80,20
170312312004,1393,1038,355,25.50,26
170312312005,629,333,296,47.10,47
170312315001,856,819,37,4.30,4
170312315002,1291,1291,0,0.00,0
170312315003,464,464,0,0.00,0
170312315004,884,884,0,0.00,0
170312315005,1544,1305,239,15.50,16
170312315006,1926,1790,136,7.10,7
170312402001,1469,1204,265,18.00,18
170312403001,1402,1335,67,4.80,5
170312405001,2154,1896,258,12.00,12
170312406001,1340,936,404,30.10,30
170312407001,1427,829,598,41.90,42
170312408001,1035,283,752,72.70,73
170312408002,781,281,500,64.00,64
170312409001,1236,539,697,56.40,56
170312410001,907,541,366,40.40,40
170312410002,1129,476,653,57.80,58
170312411001,1945,1095,850,43.70,44
170312411002,2070,1114,956,46.20,46
170312412001,1178,984,194,16.50,17
170312412002,774,529,245,31.70,32
170312413001,1878,1498,380,20.20,20
170312414001,1610,1240,370,23.00,23
170312414002,623,559,64,10.30,10
170312414003,991,961,30,3.00,3
170312414004,2014,1970,44,2.20,2
170312415001,1470,1161,309,21.00,21
170312415002,777,547,230,29.60,30
170312415003,634,612,22,3.50,4
170312416001,1263,1132,131,10.40,10
170312416002,2175,1587,588,27.00,27
170312420001,1583,991,592,37.40,37
170312420002,1802,1026,776,43.10,43
170312420003,1401,1072,329,23.50,24
170312421001,721,549,172,23.90,24
170312421002,1278,967,311,24.30,24
170312421003,1312,1163,149,11.40,11
170312422001,2062,1543,519,25.20,25
170312422002,1813,1463,350,19.30,19
170312423001,1420,1081,339,23.90,24
170312423002,1583,1475,108,6.80,7
170312424001,1121,1010,111,9.90,10
170312424002,1805,1672,133,7.40,7
170312425001,2096,1005,1091,52.10,52
170312425002,1832,1302,530,28.90,29
170312426001,1291,767,524,40.60,41
170312426002,1737,1201,536,30.90,31
170312426003,1546,1283,263,17.00,17
170312426004,1425,733,692,48.60,49
170312427001,1689,1000,689,40.80,41
170312428001,1515,1257,258,17.00,17
170312429001,1253,893,360,28.70,29
170312429002,565,288,277,49.00,49
170312430001,688,338,350,50.90,51
170312430002,1710,765,945,55.30,55
170312431001,2062,1078,984,47.70,48
170312431002,532,253,279,52.40,52
170312432001,1228,769,459,37.40,37
170312432002,962,632,330,34.30,34
170312433001,942,536,406,43.10,43
170312433002,1411,1127,284,20.10,20
170312434001,1479,816,663,44.80,45
170312434002,370,291,79,21.40,21
170312434003,1106,705,401,36.30,36
170312435001,1294,1228,66,5.10,5
170312435002,1904,1731,173,9.10,9
170312502001,1786,939,847,47.40,47
170312502002,1182,794,388,32.80,33
170312503001,1959,1127,832,42.50,43
170312503002,968,879,89,9.20,9
170312503003,1299,1220,79,6.10,6
170312503004,549,460,89,16.20,16
170312504001,446,390,56,12.60,13
170312504002,984,777,207,21.00,21
170312504003,1794,1529,265,14.80,15
170312504004,1113,931,182,16.40,16
170312504005,1626,1169,457,28.10,28
170312505001,1617,835,782,48.40,48
170312505002,1454,1438,16,1.10,1
170312505003,791,791,0,0.00,0
170312505004,697,511,186,26.70,27
170312505005,625,448,177,28.30,28
170312505006,1241,828,413,33.30,33
170312505007,1238,929,309,25.00,25
170312506001,1008,1008,0,0.00,0
170312506002,1007,882,125,12.40,12
170312506003,1088,938,150,13.80,14
170312506004,1347,1296,51,3.80,4
170312507001,1074,1074,0,0.00,0
170312507002,1005,1005,0,0.00,0
170312507003,830,830,0,0.00,0
170312507004,1403,1319,84,6.00,6
170312507005,1501,1269,232,15.50,16
170312508001,1153,858,295,25.60,26
170312508002,1285,1102,183,14.20,14
170312510001,1284,1127,157,12.20,12
170312511001,714,644,70,9.80,10
170312511002,741,718,23,3.10,3
170312511003,1694,1365,329,19.40,19
170312511004,1197,1084,113,9.40,9
170312512001,717,717,0,0.00,0
170312512002,948,948,0,0.00,0
170312512003,617,617,0,0.00,0
170312512004,2093,2050,43,2.10,2
170312513001,843,658,185,21.90,22
170312513002,918,873,45,4.90,5
170312513003,1022,982,40,3.90,4
170312513004,825,825,0,0.00,0
170312513005,1127,1098,29,2.60,3
170312514001,960,932,28,2.90,3
170312514002,647,634,13,2.00,2
170312514003,1351,1317,34,2.50,3
170312514004,1389,1290,99,7.10,7
170312515001,801,728,73,9.10,9
170312515002,860,842,18,2.10,2
170312515003,904,840,64,7.10,7
170312515004,1519,1417,102,6.70,7
170312516001,1316,1280,36,2.70,3
170312516002,789,789,0,0.00,0
170312516003,1584,1426,158,10.00,10
170312517001,1805,1469,336,18.60,19
170312518001,1260,1260,0,0.00,0
170312518002,981,981,0,0.00,0
170312518003,898,898,0,0.00,0
170312518004,361,361,0,0.00,0
170312518005,1569,1569,0,0.00,0
170312519001,502,502,0,0.00,0
170312519002,1619,1619,0,0.00,0
170312519003,1153,1153,0,0.00,0
170312519004,2725,2516,209,7.70,8
170312520001,776,715,61,7.90,8
170312520002,2387,2387,0,0.00,0
170312520003,1664,1567,97,5.80,6
170312520004,1541,1480,61,4.00,4
170312521011,1787,1719,68,3.80,4
170312521021,2457,2457,0,0.00,0
170312521022,1176,1176,0,0.00,0
170312521023,1248,1248,0,0.00,0
170312521024,1007,1007,0,0.00,0
170312522011,668,661,7,1.00,1
170312522012,818,812,6,0.70,1
170312522013,1521,1513,8,0.50,1
170312522021,996,996,0,0.00,0
170312522022,1110,1110,0,0.00,0
170312522023,1123,1123,0,0.00,0
170312522024,769,769,0,0.00,0
170312522025,873,849,24,2.70,3
170312601001,1047,1040,7,0.70,1
170312602001,1266,1230,36,2.80,3
170312603001,1483,1436,47,3.20,3
170312604001,1567,1566,1,0.10,0
170312605001,1837,1777,60,3.30,3
170312606001,1057,1057,0,0.00,0
170312606002,1535,1521,14,0.90,1
170312607001,901,891,10,1.10,1
170312607002,1246,1076,170,13.60,14
170312608001,1393,1393,0,0.00,0
170312608002,1101,1101,0,0.00,0
170312609001,981,937,44,4.50,5
170312609002,877,877,0,0.00,0
170312610001,1374,1364,10,0.70,1
170312610002,1220,1220,0,0.00,0
170312705001,1929,1886,43,2.20,2
170312712001,1104,1081,23,2.10,2
170312713001,1169,1166,3,0.30,0
170312714001,1151,1150,1,0.10,0
170312715001,1286,1268,18,1.40,1
170312718001,1230,1230,0,0.00,0
170312801001,4909,4614,295,6.00,6
170312801002,1615,1503,112,6.90,7
170312804001,1366,1358,8,0.60,1
170312808001,850,822,28,3.30,3
170312809001,790,738,52,6.60,7
170312819001,1220,1062,158,13.00,13
170312819002,1523,1523,0,0.00,0
170312819003,2077,1813,264,12.70,13
170312827001,1395,750,645,46.20,46
170312827002,1007,824,183,18.20,18
170312828001,1565,1205,360,23.00,23
170312831001,1612,1604,8,0.50,1
170312831002,1146,1068,78,6.80,7
170312832001,1481,1407,74,5.00,5
170312838001,458,430,28,6.10,6
170312838002,2909,2631,278,9.60,10
170312909001,792,792,0,0.00,0
170312909002,924,924,0,0.00,0
170312909003,759,741,18,2.40,2
170312909004,974,974,0,0.00,0
170312912001,1002,1002,0,0.00,0
170312912002,1366,1366,0,0.00,0
170312916001,804,242,562,69.90,70
170312922001,770,770,0,0.00,0
170312922002,1316,1316,0,0.00,0
170312922003,780,697,83,10.60,11
170312924001,1229,1200,29,2.40,2
170312924002,895,895,0,0.00,0
170312925001,1040,978,62,6.00,6
170312925002,1862,1795,67,3.60,4
170312925003,1128,1128,0,0.00,0
170312925004,246,246,0,0.00,0
170313005001,796,173,623,78.30,78
170313005002,2219,28,2191,98.70,99
170313006001,1515,469,1046,69.00,69
170313006002,1883,17,1866,99.10,99
170313007001,2303,9,2294,99.60,100
170313007002,1326,40,1286,97.00,97
170313007003,1065,101,964,90.50,91
170313008001,1985,0,1985,100.00,100
170313008002,2689,41,2648,98.50,99
170313009001,1466,109,1357,92.60,93
170313009002,1447,88,1359,93.90,94
170313009003,1050,14,1036,98.70,99
170313011001,1310,142,1168,89.20,89
170313011002,1872,24,1848,98.70,99
170313012001,1112,150,962,86.50,87
170313012002,544,362,182,33.50,34
170313012003,1862,134,1728,92.80,93
170313016001,2433,134,2299,94.50,95
170313016002,2080,11,2069,99.50,100
170313017011,922,5,917,99.50,100
170313017012,1830,72,1758,96.10,96
170313017013,992,70,922,92.90,93
170313017021,1061,9,1052,99.20,99
170313017022,1480,57,1423,96.10,96
170313017023,1153,33,1120,97.10,97
170313018011,1197,0,1197,100.00,100
170313018012,3049,341,2708,88.80,89
170313018021,820,23,797,97.20,97
170313018022,1081,15,1066,98.60,99
170313018023,996,21,975,97.90,98
170313018031,1539,153,1386,90.10,90
170313018032,2399,48,2351,98.00,98
170313018033,1116,13,1103,98.80,99
170313102001,831,260,571,68.70,69
170313102002,695,401,294,42.30,42
170313103001,1493,619,874,58.50,59
170313104001,1426,373,1053,73.80,74
170313105001,1722,82,1640,95.20,95
170313106001,1975,659,1316,66.60,67
170313106002,1474,364,1110,75.30,75
170313106003,1692,280,1412,83.50,84
170313107001,1241,290,951,76.60,77
170313108001,1316,179,1137,86.40,86
170313108002,1123,118,1005,89.50,90
170313108003,2295,219,2076,90.50,91
170313109001,1516,193,1323,87.30,87
170313109002,1716,212,1504,87.60,88
170313109003,1833,285,1548,84.50,85
170313201001,2885,2717,168,5.80,6
170313201002,2007,1534,473,23.60,24
170313201003,2109,2005,104,4.90,5
170313201004,3533,3471,62,1.80,2
170313204001,2523,2432,91,3.60,4
170313206001,2075,1991,84,4.00,4
170313206002,2376,2283,93,3.90,4
170313301001,3006,2771,235,7.80,8
170313301002,5070,4337,733,14.50,15
170313301003,6847,6690,157,2.30,2
170313301004,2659,2555,104,3.90,4
170313302001,827,817,10,1.20,1
170313302002,2929,2744,185,6.30,6
170313403001,1734,1658,76,4.40,4
170313404001,1740,1664,76,4.40,4
170313405001,1688,1337,351,20.80,21
170313406001,1066,1063,3,0.30,0
170313501001,743,693,50,6.70,7
170313501002,1246,1231,15,1.20,1
170313504001,1379,1327,52,3.80,4
170313510001,1011,1011,0,0.00,0
170313510002,817,817,0,0.00,0
170313510003,2194,2194,0,0.00,0
170313511001,1649,1649,0,0.00,0
170313511002,7,7,0,0.00,0
170313511003,0,0,0,#DIV/0!,#DIV/0!
170313514001,1551,1551,0,0.00,0
170313515001,0,0,0,#DIV/0!,#DIV/0!
170313515002,415,405,10,2.40,2
170313602001,1616,1616,0,0.00,0
170313801001,1822,1822,0,0.00,0
170313802001,194,185,9,4.60,5
170313802002,1558,1520,38,2.40,2
170313805001,820,818,2,0.20,0
170313807001,1216,1197,19,1.60,2
170313812001,644,644,0,0.00,0
170313812002,1302,1244,58,4.50,5
170313814001,1746,1741,5,0.30,0
170313815001,250,238,12,4.80,5
170313817001,0,0,0,#DIV/0!,#DIV/0!
170313818001,788,678,110,14.00,14
170313818002,314,300,14,4.50,5
170313819001,599,593,6,1.00,1
170313819002,694,672,22,3.20,3
170313901001,1386,1306,80,5.80,6
170313902001,999,999,0,0.00,0
170313902002,638,621,17,2.70,3
170313903001,1013,1013,0,0.00,0
170313903002,1896,1855,41,2.20,2
170313904001,1139,1139,0,0.00,0
170313904002,1385,1333,52,3.80,4
170313905001,1643,1569,74,4.50,5
170313906001,826,797,29,3.50,4
170313906002,1150,1073,77,6.70,7
170313907001,1276,1276,0,0.00,0
170313907002,1466,1390,76,5.20,5
170313907003,3400,3145,255,7.50,8
170314003001,1329,1305,24,1.80,2
170314004001,1077,1067,10,0.90,1
170314004002,584,579,5,0.90,1
170314005001,1329,1329,0,0.00,0
170314005002,1093,1093,0,0.00,0
170314008001,986,986,0,0.00,0
170314008002,1853,1852,1,0.10,0
170314101001,776,512,264,34.00,34
170314101002,1180,1050,130,11.00,11
170314102001,1248,1202,46,3.70,4
170314105001,1257,1171,86,6.80,7
170314105002,1373,1291,82,6.00,6
170314106001,1423,1411,12,0.80,1
170314106002,942,917,25,2.70,3
170314107001,1959,1850,109,5.60,6
170314108001,1258,989,269,21.40,21
170314108002,1943,1858,85,4.40,4
170314109001,796,699,97,12.20,12
170314109002,517,485,32,6.20,6
170314109003,1610,1489,121,7.50,8
170314110001,1386,1386,0,0.00,0
170314110002,552,517,35,6.30,6
170314110003,1375,1236,139,10.10,10
170314111001,1070,1052,18,1.70,2
170314111002,1176,1145,31,2.60,3
170314112001,1241,1225,16,1.30,1
170314112002,450,441,9,2.00,2
170314201001,1224,1172,52,4.20,4
170314202001,1707,1683,24,1.40,1
170314203001,2275,2208,67,2.90,3
170314204001,1216,1150,66,5.40,5
170314205001,1021,1009,12,1.20,1
170314205002,1078,1078,0,0.00,0
170314206001,1198,1186,12,1.00,1
170314206002,858,858,0,0.00,0
170314207001,598,598,0,0.00,0
170314207002,512,512,0,0.00,0
170314207003,486,453,33,6.80,7
170314207004,1007,1007,0,0.00,0
170314207005,447,446,1,0.20,0
170314208001,1163,1163,0,0.00,0
170314208002,1129,1058,71,6.30,6
170314212001,949,949,0,0.00,0
170314212002,758,741,17,2.20,2
170314301011,859,859,0,0.00,0
170314301012,886,886,0,0.00,0
170314301013,810,724,86,10.60,11
170314301014,1358,1358,0,0.00,0
170314301021,1663,1612,51,3.10,3
170314301022,660,660,0,0.00,0
170314301023,1091,1091,0,0.00,0
170314302001,475,475,0,0.00,0
170314302002,576,576,0,0.00,0
170314302003,1030,880,150,14.60,15
170314302004,1164,1161,3,0.30,0
170314302005,1682,1682,0,0.00,0
170314303001,1187,1187,0,0.00,0
170314303002,601,601,0,0.00,0
170314303003,474,474,0,0.00,0
170314304001,661,661,0,0.00,0
170314304002,408,408,0,0.00,0
170314304003,926,898,28,3.00,3
170314304004,1124,1124,0,0.00,0
170314305001,1368,1285,83,6.10,6
170314305002,1333,1320,13,1.00,1
170314305003,960,960,0,0.00,0
170314306001,705,705,0,0.00,0
170314306002,1037,1037,0,0.00,0
170314307001,1523,1498,25,1.60,2
170314307002,957,950,7,0.70,1
170314308001,965,962,3,0.30,0
170314308002,727,727,0,0.00,0
170314309001,922,922,0,0.00,0
170314309002,423,423,0,0.00,0
170314312001,1908,1887,21,1.10,1
170314312002,1383,1305,78,5.60,6
170314313011,322,307,15,4.70,5
170314313012,1578,1578,0,0.00,0
170314313013,1521,1495,26,1.70,2
170314313021,1091,1072,19,1.70,2
170314313022,646,602,44,6.80,7
170314313023,1664,1549,115,6.90,7
170314314001,2496,2405,91,3.60,4
170314314002,1228,1189,39,3.20,3
170314314003,1742,1742,0,0.00,0
170314314004,384,384,0,0.00,0
170314401011,1283,1252,31,2.40,2
170314401012,913,895,18,2.00,2
170314401013,519,471,48,9.20,9
170314401014,1032,1032,0,0.00,0
170314401021,1233,1232,1,0.10,0
170314401022,674,657,17,2.50,3
170314401023,504,504,0,0.00,0
170314401024,745,745,0,0.00,0
170314402011,1227,1227,0,0.00,0
170314402012,1716,1716,0,0.00,0
170314402013,897,831,66,7.40,7
170314402014,1503,1503,0,0.00,0
170314402021,1738,1719,19,1.10,1
170314402022,982,982,0,0.00,0
170314402023,884,884,0,0.00,0
170314403001,1044,1044,0,0.00,0
170314403002,1531,1530,1,0.10,0
170314403003,514,514,0,0.00,0
170314403004,703,703,0,0.00,0
170314403005,663,663,0,0.00,0
170314406001,660,653,7,1.10,1
170314406002,1396,1392,4,0.30,0
170314407001,703,703,0,0.00,0
170314407002,798,798,0,0.00,0
170314408001,749,749,0,0.00,0
170314408002,1028,1011,17,1.70,2
170314409001,622,621,1,0.20,0
170314409002,802,802,0,0.00,0
170314409003,1056,1056,0,0.00,0
170314503001,1603,1603,0,0.00,0
170314503002,592,577,15,2.50,3
170314503003,875,875,0,0.00,0
170314503004,646,646,0,0.00,0
170314601001,917,714,203,22.10,22
170314601002,1134,1092,42,3.70,4
170314601003,765,478,287,37.50,38
170314601004,798,408,390,48.90,49
170314602001,1044,460,584,55.90,56
170314602002,1582,989,593,37.50,38
170314603011,1224,781,443,36.20,36
170314603012,660,569,91,13.80,14
170314603013,755,501,254,33.60,34
170314603021,934,934,0,0.00,0
170314603022,660,558,102,15.50,16
170314603023,739,672,67,9.10,9
170314603024,1173,1127,46,3.90,4
170314604001,775,775,0,0.00,0
170314604002,1003,1003,0,0.00,0
170314604003,551,551,0,0.00,0
170314604004,825,825,0,0.00,0
170314605001,320,320,0,0.00,0
170314605002,470,470,0,0.00,0
170314605003,1003,964,39,3.90,4
170314605004,613,613,0,0.00,0
170314605005,644,644,0,0.00,0
170314605006,663,663,0,0.00,0
170314605007,1085,1085,0,0.00,0
170314606001,1107,922,185,16.70,17
170314607001,1522,1354,168,11.00,11
170314607002,990,326,664,67.10,67
170314607003,389,176,213,54.80,55
170314610001,2034,1033,1001,49.20,49
170314701001,1089,1089,0,0.00,0
170314701002,1529,1529,0,0.00,0
170314801001,917,917,0,0.00,0
170314801002,1128,1128,0,0.00,0
170314802001,657,657,0,0.00,0
170314802002,500,500,0,0.00,0
170314803001,785,741,44,5.60,6
170314803002,407,384,23,5.70,6
170314804001,735,717,18,2.40,2
170314804002,513,484,29,5.70,6
170314804003,1378,1378,0,0.00,0
170314804004,1251,1251,0,0.00,0
170314804005,592,592,0,0.00,0
170314804006,731,731,0,0.00,0
170314804007,906,906,0,0.00,0
170314805001,1095,1075,20,1.80,2
170314805002,751,637,114,15.20,15
170314805003,1054,783,271,25.70,26
170314903001,1303,1289,14,1.10,1
170314903002,987,952,35,3.50,4
170314904001,972,972,0,0.00,0
170314905001,972,912,60,6.20,6
170314905002,1368,1368,0,0.00,0
170314906001,1452,1451,1,0.10,0
170314907001,593,593,0,0.00,0
170314907002,817,817,0,0.00,0
170314907003,1478,1478,0,0.00,0
170314908001,724,724,0,0.00,0
170314908002,877,877,0,0.00,0
170314908003,833,809,24,2.90,3
170314908004,650,650,0,0.00,0
170314908005,685,685,0,0.00,0
170314909011,1771,1771,0,0.00,0
170314909012,1259,1257,2,0.20,0
170314909013,1185,1185,0,0.00,0
170314909021,1031,1031,0,0.00,0
170314909022,2017,2017,0,0.00,0
170314909023,664,664,0,0.00,0
170314909024,1113,1106,7,0.60,1
170314910001,600,554,46,7.70,8
170314910002,922,922,0,0.00,0
170314910003,571,571,0,0.00,0
170314910004,1457,1457,0,0.00,0
170314910005,1986,1986,0,0.00,0
170314911001,663,616,47,7.10,7
170314911002,893,893,0,0.00,0
170314911003,908,887,21,2.30,2
170314911004,977,974,3,0.30,0
170314911005,1136,1136,0,0.00,0
170314912001,1283,1283,0,0.00,0
170314912002,677,663,14,2.10,2
170314912003,786,786,0,0.00,0
170314913001,605,605,0,0.00,0
170314913002,614,608,6,1.00,1
170314913003,558,524,34,6.10,6
170314913004,566,533,33,5.80,6
170314914001,521,521,0,0.00,0
170314914002,807,807,0,0.00,0
170314914003,1370,1275,95,6.90,7
170315001001,729,729,0,0.00,0
170315001002,688,678,10,1.50,2
170315001003,648,642,6,0.90,1
170315001004,1249,1241,8,0.60,1
170315002001,1467,1451,16,1.10,1
170315002002,624,624,0,0.00,0
170315003001,695,427,268,38.60,39
170315003002,870,608,262,30.10,30
170315101001,1685,317,1368,81.20,81
170315101002,1961,303,1658,84.50,85
170315102001,693,357,336,48.50,49
170315102002,808,808,0,0.00,0
170315102003,1154,988,166,14.40,14
170315103001,1676,1676,0,0.00,0
170315103002,1289,1274,15,1.20,1
170315103003,653,653,0,0.00,0
170315103004,2419,2419,0,0.00,0
170315201001,2278,279,1999,87.80,88
170315202001,607,74,533,87.80,88
170315202002,1550,135,1415,91.30,91
170315202003,1830,413,1417,77.40,77
170315203001,1719,61,1658,96.50,97
170315203002,1785,268,1517,85.00,85
170315203003,1129,169,960,85.00,85
170315203004,1483,237,1246,84.00,84
170315204001,939,70,869,92.50,93
170315204002,1107,186,921,83.20,83
170315204003,994,121,873,87.80,88
170315204004,695,181,514,74.00,74
170315205001,561,236,325,57.90,58
170315205002,2067,816,1251,60.50,61
170315205003,1985,693,1292,65.10,65
170315206001,3010,652,2358,78.30,78
170315301001,1407,661,746,53.00,53
170315301002,684,414,270,39.50,40
170315302001,839,839,0,0.00,0
170315302002,1330,1330,0,0.00,0
170315302003,579,579,0,0.00,0
170315302004,1177,1177,0,0.00,0
170315302005,968,968,0,0.00,0
170315303001,663,663,0,0.00,0
170315303002,966,926,40,4.10,4
170315303003,1312,1312,0,0.00,0
170315303004,1512,1512,0,0.00,0
170315304001,954,933,21,2.20,2
170315304002,1063,1063,0,0.00,0
170315305011,1688,1688,0,0.00,0
170315305012,1308,1291,17,1.30,1
170315305013,650,650,0,0.00,0
170315305014,1546,1532,14,0.90,1
170315305021,1495,1495,0,0.00,0
170315305031,1304,1245,59,4.50,5
170315305032,1775,1759,16,0.90,1
170315305033,2068,2068,0,0.00,0
170315306001,1284,1274,10,0.80,1
170315306002,712,712,0,0.00,0
170315306003,876,794,82,9.40,9
170315401011,1583,1511,72,4.50,5
170315401012,493,493,0,0.00,0
170315401013,1684,1661,23,1.40,1
170315401014,162,162,0,0.00,0
170315401021,666,666,0,0.00,0
170315401022,2019,1934,85,4.20,4
170315401023,583,583,0,0.00,0
170315501001,1391,626,765,55.00,55
170315501002,658,436,222,33.70,34
170315501003,1584,779,805,50.80,51
170315501004,958,689,269,28.10,28
170315501005,515,220,295,57.30,57
170315501006,1653,492,1161,70.20,70
170315502001,1967,863,1104,56.10,56
170315502002,612,346,266,43.50,44
170315601001,1263,521,742,58.70,59
170315602001,135,98,37,27.40,27
170315602002,19,19,0,0.00,0
170315602003,1356,1206,150,11.10,11
170315603001,1817,819,998,54.90,55
170315603002,1357,609,748,55.10,55
170315604001,1417,544,873,61.60,62
170315607001,1315,651,664,50.50,51
170315607002,2171,1125,1046,48.20,48
170315608001,1823,488,1335,73.20,73
170315608002,1195,672,523,43.80,44
170315608003,959,678,281,29.30,29
170315608004,828,337,491,59.30,59
170315608005,1132,684,448,39.60,40
170315609001,1354,987,367,27.10,27
170315609002,470,319,151,32.10,32
170315609003,726,512,214,29.50,30
170315609004,1428,804,624,43.70,44
170315609005,874,592,282,32.30,32
170315609006,525,468,57,10.90,11
170315610001,1074,651,423,39.40,39
170315610002,598,298,300,50.20,50
170315610003,762,651,111,14.60,15
170315610004,775,539,236,30.50,31
170315610005,971,364,607,62.50,63
170315610006,712,443,269,37.80,38
170315611001,724,170,554,76.50,77
170315611002,1052,767,285,27.10,27
170315611003,895,465,430,48.00,48
170315611004,1268,897,371,29.30,29
170315611005,965,774,191,19.80,20
170315611006,912,531,381,41.80,42
170315701001,1296,313,983,75.80,76
170315702001,1878,528,1350,71.90,72
170315703001,1625,492,1133,69.70,70
170315703002,1106,226,880,79.60,80
170315703003,1890,409,1481,78.40,78
170315703004,1716,364,1352,78.80,79
170315704001,1053,255,798,75.80,76
170315704002,880,98,782,88.90,89
170315705001,1181,225,956,80.90,81
170315705002,1373,503,870,63.40,63
170315801001,1594,479,1115,69.90,70
170315801002,1402,429,973,69.40,69
170315802001,1690,427,1263,74.70,75
170315802002,1692,150,1542,91.10,91
170315803001,2334,217,2117,90.70,91
170315804001,1185,138,1047,88.40,88
170315804002,1261,219,1042,82.60,83
170315804003,1163,310,853,73.30,73
170315804004,442,246,196,44.30,44
170315805011,1404,100,1304,92.90,93
170315805012,648,166,482,74.40,74
170315805013,1925,282,1643,85.40,85
170315805014,1082,268,814,75.20,75
170315805021,1275,288,987,77.40,77
170315805022,1425,105,1320,92.60,93
170315805023,2193,399,1794,81.80,82
170315806001,996,171,825,82.80,83
170315806002,1253,161,1092,87.20,87
170315806003,1236,105,1131,91.50,92
170315806004,2339,180,2159,92.30,92
170315807001,717,87,630,87.90,88
170315807002,4033,562,3471,86.10,86
170315807003,1542,109,1433,92.90,93
170315808001,1661,131,1530,92.10,92
170315905001,1842,1013,829,45.00,45
170315906001,1570,469,1101,70.10,70
170315906002,1584,617,967,61.00,61
170315906003,800,277,523,65.40,65
170315907001,1574,474,1100,69.90,70
170315907002,1660,537,1123,67.70,68
170316004001,1748,1554,194,11.10,11
170316004002,1053,913,140,13.30,13
170316004003,1947,1360,587,30.10,30
170316006001,1728,1012,716,41.40,41
170316006002,766,536,230,30.00,30
170316007001,785,481,304,38.70,39
170316007002,1415,1035,380,26.90,27
170316009001,927,540,387,41.70,42
170316009002,821,698,123,15.00,15
170316009003,725,360,365,50.30,50
170316009004,1185,1071,114,9.60,10
170316103001,2244,195,2049,91.30,91
170316103002,2141,180,1961,91.60,92
170316103003,1332,531,801,60.10,60
170316104001,1897,89,1808,95.30,95
170316108001,1549,1294,255,16.50,17
170316110001,1188,682,506,42.60,43
170316111001,723,107,616,85.20,85
170316111002,685,494,191,27.90,28
170316111003,1250,93,1157,92.60,93
170316112001,912,107,805,88.30,88
170316112002,1428,566,862,60.40,60
170316113001,488,61,427,87.50,88
170316113002,1211,500,711,58.70,59
170316113003,1069,147,922,86.20,86
170316114001,1580,75,1505,95.30,95
170316114002,622,198,424,68.20,68
170316114003,1342,63,1279,95.30,95
170316115001,1185,27,1158,97.70,98
170316115002,1793,407,1386,77.30,77
170316116001,586,94,492,84.00,84
170316116002,943,886,57,6.00,6
170316117001,510,322,188,36.90,37
170316117002,150,68,82,54.70,55
170316117003,675,563,112,16.60,17
170316118001,1934,890,1044,54.00,54
170316118002,509,439,70,13.80,14
170316119001,1378,1169,209,15.20,15
170316119002,776,706,70,9.00,9
170316120001,642,533,109,17.00,17
170316120002,944,899,45,4.80,5
170316121001,1068,1039,29,2.70,3
170316201001,1417,284,1133,80.00,80
170316201002,1768,351,1417,80.10,80
170316201003,1580,218,1362,86.20,86
170316202001,887,381,506,57.00,57
170316202002,1556,355,1201,77.20,77
170316203001,888,190,698,78.60,79
170316203002,989,307,682,69.00,69
170316203003,1124,314,810,72.10,72
170316203004,1196,261,935,78.20,78
170316203005,1022,390,632,61.80,62
170316203006,1831,369,1462,79.80,80
170316204001,1628,92,1536,94.30,94
170316204002,876,91,785,89.60,90
170316204003,953,65,888,93.20,93
170316204004,1450,143,1307,90.10,90
170316301001,1135,202,933,82.20,82
170316302001,2217,169,2048,92.40,92
170316303001,1916,61,1855,96.80,97
170316303002,3416,298,3118,91.30,91
170316304001,1765,89,1676,95.00,95
170316304002,1661,63,1598,96.20,96
170316304003,1565,66,1499,95.80,96
170316304004,1844,152,1692,91.80,92
170316305001,2051,93,1958,95.50,96
170316305002,2074,100,1974,95.20,95
170316305003,1432,55,1377,96.20,96
170316305004,1106,32,1074,97.10,97
170316308001,1995,148,1847,92.60,93
170316308002,2544,158,2386,93.80,94
170316308003,1426,9,1417,99.40,99
170316308004,1491,282,1209,81.10,81
170316309001,2174,84,2090,96.10,96
170316309002,1322,99,1223,92.50,93
170316309003,1692,88,1604,94.80,95
170316401001,1230,463,767,62.40,62
170316403001,1147,687,460,40.10,40
170316403002,1015,325,690,68.00,68
170316403003,637,486,151,23.70,24
170316403004,1839,1015,824,44.80,45
170316403005,1314,747,567,43.20,43
170316403006,995,583,412,41.40,41
170316404001,1575,838,737,46.80,47
170316404002,2078,1015,1063,51.20,51
170316405001,1701,1174,527,31.00,31
170316405002,1482,834,648,43.70,44
170316406001,1234,462,772,62.60,63
170316406002,1264,902,362,28.60,29
170316406003,1934,1187,747,38.60,39
170316407001,872,172,700,80.30,80
170316407002,698,424,274,39.30,39
170316407003,858,515,343,40.00,40
170316407004,807,158,649,80.40,80
170316408001,1024,251,773,75.50,76
170316408002,748,209,539,72.10,72
170316501001,1247,137,1110,89.00,89
170316501002,1272,29,1243,97.70,98
170316501003,1202,185,1017,84.60,85
170316501004,789,75,714,90.50,91
170316502001,1570,543,1027,65.40,65
170316502002,2230,739,1491,66.90,67
170316502003,1208,207,1001,82.90,83
170316502004,1462,386,1076,73.60,74
170316502005,651,146,505,77.60,78
170316502006,507,163,344,67.90,68
170316503011,1144,181,963,84.20,84
170316503012,1921,398,1523,79.30,79
170316503013,1405,296,1109,78.90,79
170316503014,1274,207,1067,83.80,84
170316503021,1730,475,1255,72.50,73
170316503022,2418,158,2260,93.50,94
170316504001,884,71,813,92.00,92
170316504002,956,317,639,66.80,67
170316504003,1283,160,1123,87.50,88
170316504004,2631,236,2395,91.00,91
170316504005,1530,256,1274,83.30,83
170316505001,1118,98,1020,91.20,91
170316505002,1296,274,1022,78.90,79
170316505003,1749,814,935,53.50,54
170316603011,1790,852,938,52.40,52
170316603021,1597,107,1490,93.30,93
170316603022,1657,452,1205,72.70,73
170316603023,1038,152,886,85.40,85
170316603024,1262,345,917,72.70,73
170316604001,1578,104,1474,93.40,93
170316604002,1877,285,1592,84.80,85
170316604003,959,43,916,95.50,96
170316604004,1561,148,1413,90.50,91
170316605001,1604,245,1359,84.70,85
170316605002,1182,538,644,54.50,55
170316605003,1286,93,1193,92.80,93
170316605004,1630,215,1415,86.80,87
170316606001,1151,934,217,18.90,19
170316606002,842,842,0,0.00,0
170316606003,1189,793,396,33.30,33
170316606004,1457,677,780,53.50,54
170316606005,1525,879,646,42.40,42
170316607001,1355,1315,40,3.00,3
170316607002,1322,1322,0,0.00,0
170316608001,714,714,0,0.00,0
170316608002,1510,1223,287,19.00,19
170316608003,1516,532,984,64.90,65
170316608004,819,457,362,44.20,44
170316608005,1958,578,1380,70.50,71
170316609001,1803,1722,81,4.50,5
170316609002,1138,1115,23,2.00,2
170316609003,1416,1237,179,12.60,13
170316610001,821,796,25,3.00,3
170316610002,1137,1116,21,1.80,2
170316610003,735,735,0,0.00,0
170316610004,1549,1518,31,2.00,2
170316610005,1475,1380,95,6.40,6
170316611001,1309,1159,150,11.50,12
170316611002,850,700,150,17.60,18
170316611003,1027,747,280,27.30,27
170316611004,1249,379,870,69.70,70
170316611005,1594,387,1207,75.70,76
170316701001,760,760,0,0.00,0
170316701002,841,790,51,6.10,6
170316702001,985,899,86,8.70,9
170316703001,511,511,0,0.00,0
170316703002,870,782,88,10.10,10
170316704001,1858,1635,223,12.00,12
170316705001,1040,918,122,11.70,12
170316706001,915,832,83,9.10,9
170316706002,721,721,0,0.00,0
170316707001,835,835,0,0.00,0
170316707002,712,696,16,2.20,2
170316708001,472,472,0,0.00,0
170316708002,1216,1216,0,0.00,0
170316709001,506,501,5,1.00,1
170316709002,990,990,0,0.00,0
170316711001,1486,1486,0,0.00,0
170316712001,488,488,0,0.00,0
170316712002,575,575,0,0.00,0
170316713001,1252,1252,0,0.00,0
170316713002,550,550,0,0.00,0
170316713003,388,388,0,0.00,0
170316714001,929,871,58,6.20,6
170316714002,935,922,13,1.40,1
170316715001,787,765,22,2.80,3
170316715002,1460,1319,141,9.70,10
170316715003,1007,984,23,2.30,2
170316716001,1162,1125,37,3.20,3
170316716002,743,743,0,0.00,0
170316716003,386,271,115,29.80,30
170316718001,1139,1137,2,0.20,0
170316719001,1313,1313,0,0.00,0
170316720001,1787,1787,0,0.00,0
170316720002,703,703,0,0.00,0
170316720003,1234,1044,190,15.40,15
170316720004,424,420,4,0.90,1
170316805001,430,375,55,12.80,13
170316805002,855,802,53,6.20,6
170316806001,663,663,0,0.00,0
170316806002,931,931,0,0.00,0
170316809001,810,794,16,2.00,2
170316809002,449,434,15,3.30,3
170316809003,697,695,2,0.30,0
170316809004,1433,1433,0,0.00,0
170316810001,620,620,0,0.00,0
170316810002,576,576,0,0.00,0
170316810003,418,418,0,0.00,0
170316810004,1259,1182,77,6.10,6
170316811001,810,810,0,0.00,0
170316811002,745,745,0,0.00,0
170316811003,427,427,0,0.00,0
170316811004,924,908,16,1.70,2
170316811005,677,662,15,2.20,2
170316812001,458,458,0,0.00,0
170316812002,681,681,0,0.00,0
170316812003,635,635,0,0.00,0
170316812004,601,601,0,0.00,0
170316813001,777,765,12,1.50,2
170316813002,921,804,117,12.70,13
170316813003,711,711,0,0.00,0
170316814001,421,421,0,0.00,0
170316814002,915,915,0,0.00,0
170316814003,980,980,0,0.00,0
170316814004,582,582,0,0.00,0
170316903001,616,616,0,0.00,0
170316903002,1668,1650,18,1.10,1
170316904001,830,811,19,2.30,2
170316904002,911,893,18,2.00,2
170316904003,871,825,46,5.30,5
170316904004,969,921,48,5.00,5
170316905001,952,952,0,0.00,0
170316909001,947,936,11,1.20,1
170316909002,515,515,0,0.00,0
170316909003,944,920,24,2.50,3
170316909004,968,968,0,0.00,0
170316909005,1068,1059,9,0.80,1
170316910001,847,847,0,0.00,0
170316910002,950,950,0,0.00,0
170316910003,530,522,8,1.50,2
170316910004,376,376,0,0.00,0
170316911001,553,527,26,4.70,5
170316911002,715,715,0,0.00,0
170316911003,914,893,21,2.30,2
170316911004,1027,1018,9,0.90,1
170316912001,1275,1275,0,0.00,0
170316912002,830,830,0,0.00,0
170316912003,870,870,0,0.00,0
170316913001,1347,1315,32,2.40,2
170316913002,1495,1487,8,0.50,1
170316914001,363,354,9,2.50,3
170316914002,369,369,0,0.00,0
170316914003,515,515,0,0.00,0
170316914004,884,884,0,0.00,0
170316914005,585,575,10,1.70,2
170316915001,473,439,34,7.20,7
170316915002,1008,899,109,10.80,11
170316915003,643,643,0,0.00,0
170317001001,2267,1815,452,19.90,20
170317001002,1219,543,676,55.50,56
170317002001,1814,323,1491,82.20,82
170317002002,1893,576,1317,69.60,70
170317002003,1686,447,1239,73.50,74
170317002004,1475,693,782,53.00,53
170317003011,1787,608,1179,66.00,66
170317003012,2102,885,1217,57.90,58
170317003013,1907,649,1258,66.00,66
170317003021,1217,723,494,40.60,41
170317003022,979,668,311,31.80,32
170317003023,1528,531,997,65.20,65
170317003024,1962,1009,953,48.60,49
170317004011,1595,1301,294,18.40,18
170317004012,2058,1018,1040,50.50,51
170317004013,1688,1013,675,40.00,40
170317004014,920,920,0,0.00,0
170317004021,979,696,283,28.90,29
170317004022,1207,971,236,19.60,20
170317004023,1654,1478,176,10.60,11
170317005011,1616,1616,0,0.00,0
170317005012,1306,1290,16,1.20,1
170317005013,1932,1806,126,6.50,7
170317005014,1623,1623,0,0.00,0
170317005015,568,568,0,0.00,0
170317005016,826,744,82,9.90,10
170317005021,1384,1294,90,6.50,7
170317005022,1617,1617,0,0.00,0
170317101001,1406,1340,66,4.70,5
170317102001,866,866,0,0.00,0
170317102002,852,852,0,0.00,0
170317102003,1271,1271,0,0.00,0
170317102004,962,962,0,0.00,0
170317102005,1894,1783,111,5.90,6
170317103001,1365,1355,10,0.70,1
170317104001,909,882,27,3.00,3
170317104002,686,669,17,2.50,3
170317104003,789,789,0,0.00,0
170317104004,802,792,10,1.20,1
170317104005,1129,1129,0,0.00,0
170317104006,777,777,0,0.00,0
170317105001,980,962,18,1.80,2
170317105002,1442,1359,83,5.80,6
170317105003,694,685,9,1.30,1
170317105004,1020,1020,0,0.00,0
170317106001,1019,1019,0,0.00,0
170317106002,784,784,0,0.00,0
170317107001,555,555,0,0.00,0
170317107002,536,536,0,0.00,0
170317107003,873,843,30,3.40,3
170317107004,731,731,0,0.00,0
170317108001,426,426,0,0.00,0
170317108002,823,823,0,0.00,0
170317108003,1472,1472,0,0.00,0
170317108004,941,883,58,6.20,6
170317108005,576,555,21,3.60,4
170317108006,679,678,1,0.10,0
170317109001,880,876,4,0.50,1
170317109002,1611,1587,24,1.50,2
170317110001,1215,1197,18,1.50,2
170317110002,1533,1533,0,0.00,0
170317110003,697,697,0,0.00,0
170317111001,1486,1486,0,0.00,0
170317111002,951,951,0,0.00,0
170317111003,699,699,0,0.00,0
170317112001,1456,1456,0,0.00,0
170317112002,994,994,0,0.00,0
170317112003,665,665,0,0.00,0
170317112004,1813,1813,0,0.00,0
170317113001,748,741,7,0.90,1
170317113002,832,797,35,4.20,4
170317114001,1143,1062,81,7.10,7
170317114002,649,649,0,0.00,0
170317114003,457,457,0,0.00,0
170317115001,1051,1051,0,0.00,0
170317115002,1472,1430,42,2.90,3
170317201001,1271,1086,185,14.60,15
170317201002,1255,1137,118,9.40,9
170317201003,1159,1051,108,9.30,9
170317202001,828,747,81,9.80,10
170317202002,1146,1020,126,11.00,11
170317202003,2370,2333,37,1.60,2
170317203001,779,748,31,4.00,4
170317203002,889,851,38,4.30,4
170317203003,1195,1062,133,11.10,11
170317203004,809,788,21,2.60,3
170317204001,746,716,30,4.00,4
170317204002,1228,1153,75,6.10,6
170317205001,719,707,12,1.70,2
170317205002,1470,1358,112,7.60,8
170317206001,877,861,16,1.80,2
170317206002,832,826,6,0.70,1
170317207001,1445,1434,11,0.80,1
170317207002,1361,1344,17,1.20,1
170317207003,623,611,12,1.90,2
170317301001,717,708,9,1.30,1
170317301002,850,850,0,0.00,0
170317301003,981,967,14,1.40,1
170317302011,925,925,0,0.00,0
170317302012,890,887,3,0.30,0
170317302013,1136,1120,16,1.40,1
170317302014,2036,1976,60,2.90,3
170317302015,837,791,46,5.50,6
170317302021,1147,1053,94,8.20,8
170317302022,1447,1447,0,0.00,0
170317302023,885,879,6,0.70,1
170317303001,983,979,4,0.40,0
170317304001,855,842,13,1.50,2
170317304002,1388,1368,20,1.40,1
170317304003,650,650,0,0.00,0
170317304004,908,888,20,2.20,2
170317305001,1099,1099,0,0.00,0
170317305002,880,855,25,2.80,3
170317305003,798,798,0,0.00,0
170317305004,1546,1534,12,0.80,1
170317306001,780,780,0,0.00,0
170317306002,1037,1037,0,0.00,0
170317306003,1401,1401,0,0.00,0
170317307001,1116,1099,17,1.50,2
170317307002,1143,1143,0,0.00,0
170317401001,468,468,0,0.00,0
170317401002,343,343,0,0.00,0
170317401003,947,881,66,7.00,7
170317401004,1047,980,67,6.40,6
170317402001,1954,1910,44,2.30,2
170317402002,952,808,144,15.10,15
170317402003,1390,1304,86,6.20,6
170317402004,2011,1968,43,2.10,2
170317403001,878,823,55,6.30,6
170317403002,1155,1007,148,12.80,13
170317403003,893,863,30,3.40,3
170317403004,494,446,48,9.70,10
170317403005,1016,921,95,9.40,9
170317404001,614,602,12,2.00,2
170317404002,1076,1076,0,0.00,0
170317404003,2221,2120,101,4.50,5
170317404004,898,797,101,11.20,11
170317501001,931,931,0,0.00,0
170317501002,1025,1025,0,0.00,0
170317501003,888,888,0,0.00,0
170317501004,1567,1554,13,0.80,1
170317502001,730,730,0,0.00,0
170317502002,710,710,0,0.00,0
170317502003,734,734,0,0.00,0
170317502004,701,692,9,1.30,1
170317503001,693,652,41,5.90,6
170317503002,953,945,8,0.80,1
170317503003,1011,815,196,19.40,19
170317504001,1421,1344,77,5.40,5
170317504002,1020,1020,0,0.00,0
170317504003,746,746,0,0.00,0
170317505001,1567,1545,22,1.40,1
170317505002,1019,997,22,2.20,2
170317505003,2128,2128,0,0.00,0
170317505004,1655,1441,214,12.90,13
170317506001,1085,1074,11,1.00,1
170317506002,959,949,10,1.00,1
170317506003,1032,1032,0,0.00,0
170317506004,629,629,0,0.00,0
170317608011,2561,2507,54,2.10,2
170317608012,1838,1698,140,7.60,8
170317608021,2401,2146,255,10.60,11
170317608031,2126,2126,0,0.00,0
170317608032,1714,1394,320,18.70,19
170317608033,1807,1399,408,22.60,23
170317608034,1696,1198,498,29.40,29
170317702011,1454,1255,199,13.70,14
170317702012,2274,2065,209,9.20,9
170317702013,1912,1645,267,14.00,14
170317702021,1827,1607,220,12.00,12
170317702022,1571,1456,115,7.30,7
170317702023,1538,1379,159,10.30,10
170317703001,673,616,57,8.50,9
170317703002,1579,1312,267,16.90,17
170317703003,1600,1533,67,4.20,4
170317703004,1919,1693,226,11.80,12
170317703005,1511,1406,105,6.90,7
170317704001,1686,1379,307,18.20,18
170317704002,1593,1398,195,12.20,12
170317704003,1437,968,469,32.60,33
170317705001,3394,442,2952,87.00,87
170317705002,679,127,552,81.30,81
170317706011,1158,941,217,18.70,19
170317706012,1137,1080,57,5.00,5
170317706013,868,532,336,38.70,39
170317706021,1909,1127,782,41.00,41
170317706022,1453,322,1131,77.80,78
170317706023,1371,1167,204,14.90,15
170317707001,836,722,114,13.60,14
170317707002,1754,1568,186,10.60,11
170317708001,2009,1391,618,30.80,31
170317708002,3851,3126,725,18.80,19
170317709011,1015,984,31,3.10,3
170317709012,1233,1097,136,11.00,11
170317709013,952,883,69,7.20,7
170317709014,2037,1871,166,8.10,8
170317709021,1681,1583,98,5.80,6
170317709022,1682,1656,26,1.50,2
170318001001,1197,1175,22,1.80,2
170318001002,1396,1388,8,0.60,1
170318002001,1291,1257,34,2.60,3
170318002002,1295,1185,110,8.50,9
170318002003,667,612,55,8.20,8
170318002004,1008,992,16,1.60,2
170318002005,1117,1117,0,0.00,0
170318002006,853,853,0,0.00,0
170318003001,1188,1069,119,10.00,10
170318003002,497,497,0,0.00,0
170318003003,1625,1594,31,1.90,2
170318004001,1099,1089,10,0.90,1
170318004002,1494,1494,0,0.00,0
170318004003,1123,1078,45,4.00,4
170318005001,835,835,0,0.00,0
170318005002,1102,1098,4,0.40,0
170318005003,1043,1043,0,0.00,0
170318005004,1270,1261,9,0.70,1
170318005005,1016,910,106,10.40,10
170318006001,1512,1512,0,0.00,0
170318006002,1086,1035,51,4.70,5
170318007001,702,583,119,17.00,17
170318007002,2221,2142,79,3.60,4
170318007003,894,852,42,4.70,5
170318007004,1233,1174,59,4.80,5
170318008001,2157,2107,50,2.30,2
170318009001,1493,1221,272,18.20,18
170318009002,518,483,35,6.80,7
170318009003,1414,1333,81,5.70,6
170318009004,1158,1082,76,6.60,7
170318010001,653,653,0,0.00,0
170318010002,1169,1144,25,2.10,2
170318010003,1345,1305,40,3.00,3
170318010004,1638,1620,18,1.10,1
170318011001,721,699,22,3.10,3
170318011002,875,859,16,1.80,2
170318011003,1286,1230,56,4.40,4
170318011004,1740,1683,57,3.30,3
170318012001,1482,1400,82,5.50,6
170318012002,681,629,52,7.60,8
170318012003,1291,1290,1,0.10,0
170318013001,900,900,0,0.00,0
170318013002,1248,1211,37,3.00,3
170318013003,997,986,11,1.10,1
170318013004,1460,1379,81,5.50,6
170318014001,1495,1374,121,8.10,8
170318014002,1522,1327,195,12.80,13
170318015001,2362,2301,61,2.60,3
170318015002,2458,2305,153,6.20,6
170318015003,1915,1887,28,1.50,2
170318016011,2469,2428,41,1.70,2
170318016012,1873,1855,18,1.00,1
170318016031,1284,1174,110,8.60,9
170318016032,2588,2535,53,2.00,2
170318016051,1291,1253,38,2.90,3
170318016052,989,959,30,3.00,3
170318016053,1556,1506,50,3.20,3
170318016054,805,805,0,0.00,0
170318016055,780,780,0,0.00,0
170318016061,671,671,0,0.00,0
170318016062,1110,1097,13,1.20,1
170318016063,1462,1345,117,8.00,8
170318016064,1013,1013,0,0.00,0
170318016065,1574,1510,64,4.10,4
170318016071,1442,1382,60,4.20,4
170318016072,1259,1232,27,2.10,2
170318016073,2648,2525,123,4.60,5
170318016081,1427,1314,113,7.90,8
170318016082,1397,1367,30,2.10,2
170318016083,963,879,84,8.70,9
170318016084,2521,2461,60,2.40,2
170318017011,1906,1879,27,1.40,1
170318017012,1684,1618,66,3.90,4
170318017021,1429,1322,107,7.50,8
170318017022,1282,1260,22,1.70,2
170318017023,1519,1519,0,0.00,0
170318017024,663,663,0,0.00,0
170318018001,1599,1599,0,0.00,0
170318018002,1154,1115,39,3.40,3
170318018003,1510,1510,0,0.00,0
170318018004,1181,1181,0,0.00,0
170318019011,2111,2055,56,2.70,3
170318019012,1413,800,613,43.40,43
170318019013,818,765,53,6.50,7
170318019021,1037,1037,0,0.00,0
170318019022,1451,1312,139,9.60,10
170318019023,846,831,15,1.80,2
170318020021,2827,2656,171,6.00,6
170318020022,2648,2538,110,4.20,4
170318020031,2785,2213,572,20.50,21
170318020041,773,726,47,6.10,6
170318020042,1698,1161,537,31.60,32
170318020043,1812,1812,0,0.00,0
170318020044,1271,901,370,29.10,29
170318021001,711,711,0,0.00,0
170318021002,860,845,15,1.70,2
170318021003,1764,1720,44,2.50,3
170318022001,1174,1116,58,4.90,5
170318022002,1278,1205,73,5.70,6
170318022003,1730,1658,72,4.20,4
170318023001,5174,4881,293,5.70,6
170318024021,1656,669,987,59.60,60
170318024022,1269,1107,162,12.80,13
170318024023,1226,1010,216,17.60,18
170318024024,1302,514,788,60.50,61
170318024031,1457,1404,53,3.60,4
170318024041,2116,1205,911,43.10,43
170318024042,2383,1534,849,35.60,36
170318024043,1018,604,414,40.70,41
170318024044,1868,1346,522,27.90,28
170318025031,918,892,26,2.80,3
170318025032,1820,1730,90,4.90,5
170318025033,1920,1901,19,1.00,1
170318025034,854,410,444,52.00,52
170318025041,1585,791,794,50.10,50
170318025042,1174,411,763,65.00,65
170318025043,2315,1762,553,23.90,24
170318025044,1602,1132,470,29.30,29
170318025051,2768,810,1958,70.70,71
170318025052,861,378,483,56.10,56
170318025053,3259,2158,1101,33.80,34
170318025061,1511,578,933,61.70,62
170318025062,1393,601,792,56.90,57
170318026051,1713,1712,1,0.10,0
170318026052,1418,1373,45,3.20,3
170318026053,1391,1269,122,8.80,9
170318026054,1446,1190,256,17.70,18
170318026055,1236,1080,156,12.60,13
170318026071,1329,1298,31,2.30,2
170318026081,1674,1659,15,0.90,1
170318026082,2772,2684,88,3.20,3
170318026083,982,982,0,0.00,0
170318026084,1037,878,159,15.30,15
170318026091,2067,1492,575,27.80,28
170318026092,808,0,808,100.00,100
170318026093,1474,762,712,48.30,48
170318026094,2128,1106,1022,48.00,48
170318026101,1614,1525,89,5.50,6
170318027011,2300,1045,1255,54.60,55
170318027012,1776,1512,264,14.90,15
170318027013,897,864,33,3.70,4
170318027014,1742,1742,0,0.00,0
170318027021,1773,1646,127,7.20,7
170318027022,2078,1932,146,7.00,7
170318027023,867,794,73,8.40,8
170318028011,828,828,0,0.00,0
170318028012,1456,1200,256,17.60,18
170318028013,827,789,38,4.60,5
170318028014,1069,1028,41,3.80,4
170318028015,925,925,0,0.00,0
170318028021,1436,1418,18,1.30,1
170318028022,1302,1302,0,0.00,0
170318028023,1454,1454,0,0.00,0
170318028024,1003,865,138,13.80,14
170318028025,1273,1033,240,18.90,19
170318029001,898,898,0,0.00,0
170318029002,1441,1441,0,0.00,0
170318029003,2350,2338,12,0.50,1
170318029004,1363,1329,34,2.50,3
170318030051,1111,1111,0,0.00,0
170318030052,1633,1610,23,1.40,1
170318030071,1353,1253,100,7.40,7
170318030072,1188,1159,29,2.40,2
170318030073,2261,2088,173,7.70,8
170318030081,1618,1383,235,14.50,15
170318030082,1012,994,18,1.80,2
170318030083,1912,1790,122,6.40,6
170318030101,853,661,192,22.50,23
170318030102,703,584,119,16.90,17
170318030103,1087,1038,49,4.50,5
170318030104,2055,1979,76,3.70,4
170318030121,2319,2076,243,10.50,11
170318030131,2178,2137,41,1.90,2
170318030132,1962,1939,23,1.20,1
170318030133,1129,1032,97,8.60,9
170318030141,1837,1430,407,22.20,22
170318030142,1459,1292,167,11.40,11
170318030151,1677,1620,57,3.40,3
170318030152,1834,1608,226,12.30,12
170318030153,1024,958,66,6.40,6
170318030161,2361,2216,145,6.10,6
170318030171,1921,1921,0,0.00,0
170318030172,2413,2274,139,5.80,6
170318030173,1170,993,177,15.10,15
170318031001,1808,1775,33,1.80,2
170318031002,1523,1484,39,2.60,3
170318032001,1683,1466,217,12.90,13
170318032002,2889,2739,150,5.20,5
170318032003,1326,1135,191,14.40,14
170318033001,2422,2343,79,3.30,3
170318033002,1830,1637,193,10.50,11
170318033003,1477,1476,1,0.10,0
170318034001,1038,986,52,5.00,5
170318034002,660,603,57,8.60,9
170318034003,813,739,74,9.10,9
170318034004,1492,1342,150,10.10,10
170318034005,1034,925,109,10.50,11
170318034006,1160,1105,55,4.70,5
170318035001,721,703,18,2.50,3
170318035002,983,983,0,0.00,0
170318035003,1605,1553,52,3.20,3
170318035004,2122,2122,0,0.00,0
170318035005,896,818,78,8.70,9
170318036031,2047,2047,0,0.00,0
170318036032,1281,1280,1,0.10,0
170318036033,2207,2119,88,4.00,4
170318036034,1190,1142,48,4.00,4
170318036041,1160,1114,46,4.00,4
170318036042,1335,1277,58,4.30,4
170318036043,1215,1184,31,2.60,3
170318036044,740,686,54,7.30,7
170318036051,1455,1408,47,3.20,3
170318036052,1367,1282,85,6.20,6
170318036053,1256,1201,55,4.40,4
170318036054,3384,2314,1070,31.60,32
170318036061,2269,860,1409,62.10,62
170318036062,2289,490,1799,78.60,79
170318036063,3377,1847,1530,45.30,45
170318036064,1231,635,596,48.40,48
170318036071,926,866,60,6.50,7
170318036072,982,980,2,0.20,0
170318036073,2079,1997,82,3.90,4
170318036074,1059,1000,59,5.60,6
170318036081,2732,2603,129,4.70,5
170318036082,2674,2317,357,13.40,13
170318036083,2367,1851,516,21.80,22
170318036101,1595,1438,157,9.80,10
170318036102,859,859,0,0.00,0
170318036103,1643,1547,96,5.80,6
170318036104,3394,2855,539,15.90,16
170318036111,583,555,28,4.80,5
170318036112,1195,270,925,77.40,77
170318036113,1694,1133,561,33.10,33
170318036114,581,470,111,19.10,19
170318036115,1828,923,905,49.50,50
170318036121,2281,652,1629,71.40,71
170318036122,1325,1256,69,5.20,5
170318037011,1096,1076,20,1.80,2
170318037012,1562,1400,162,10.40,10
170318037021,828,820,8,1.00,1
170318037022,1788,1663,125,7.00,7
170318037023,1915,1657,258,13.50,14
170318037024,1421,1347,74,5.20,5
170318038001,1202,1084,118,9.80,10
170318038002,902,716,186,20.60,21
170318038003,1894,1649,245,12.90,13
170318038004,1002,851,151,15.10,15
170318039011,1772,1669,103,5.80,6
170318039012,1591,1295,296,18.60,19
170318039021,1303,961,342,26.20,26
170318039022,1024,903,121,11.80,12
170318039023,1383,1288,95,6.90,7
170318040001,1745,1325,420,24.10,24
170318040002,2742,2591,151,5.50,6
170318041021,2152,2021,131,6.10,6
170318041022,2038,2038,0,0.00,0
170318041023,2431,2337,94,3.90,4
170318041041,1782,1747,35,2.00,2
170318041042,1995,1877,118,5.90,6
170318041043,1302,1177,125,9.60,10
170318041051,1823,1728,95,5.20,5
170318041052,1620,1503,117,7.20,7
170318041053,877,846,31,3.50,4
170318041061,1881,1881,0,0.00,0
170318041062,2012,1823,189,9.40,9
170318041063,1501,1394,107,7.10,7
170318041064,1615,1525,90,5.60,6
170318041081,1068,1011,57,5.30,5
170318041082,2747,2432,315,11.50,12
170318041091,1310,1297,13,1.00,1
170318041092,1682,1437,245,14.60,15
170318042011,2055,1895,160,7.80,8
170318042012,2612,2612,0,0.00,0
170318042013,1966,1966,0,0.00,0
170318042014,1356,1246,110,8.10,8
170318042021,586,586,0,0.00,0
170318042022,3158,2694,464,14.70,15
170318042023,668,668,0,0.00,0
170318042024,3426,3376,50,1.50,2
170318043051,2103,927,1176,55.90,56
170318043052,1241,953,288,23.20,23
170318043053,1953,799,1154,59.10,59
170318043054,2665,1926,739,27.70,28
170318043061,2319,1468,851,36.70,37
170318043062,1033,627,406,39.30,39
170318043063,1888,441,1447,76.60,77
170318043064,898,806,92,10.20,10
170318043081,1765,1661,104,5.90,6
170318043082,2320,2034,286,12.30,12
170318043083,1072,953,119,11.10,11
170318043091,1812,1063,749,41.30,41
170318043092,1145,830,315,27.50,28
170318043101,2170,1889,281,12.90,13
170318043102,3713,2689,1024,27.60,28
170318043103,1770,1603,167,9.40,9
170318043104,1705,1410,295,17.30,17
170318043111,1823,1692,131,7.20,7
170318043112,6684,4027,2657,39.80,40
170318044031,1248,476,772,61.90,62
170318044032,920,467,453,49.20,49
170318044033,4666,3075,1591,34.10,34
170318044041,1663,356,1307,78.60,79
170318044042,1034,202,832,80.50,81
170318044043,1558,1239,319,20.50,21
170318044044,1071,453,618,57.70,58
170318044051,2388,583,1805,75.60,76
170318044052,988,553,435,44.00,44
170318044061,2254,1345,909,40.30,40
170318044062,2661,1098,1563,58.70,59
170318044063,1279,727,552,43.20,43
170318045051,1029,781,248,24.10,24
170318045052,1298,915,383,29.50,30
170318045053,1325,1210,115,8.70,9
170318045061,1150,1096,54,4.70,5
170318045062,1276,1227,49,3.80,4
170318045063,2562,2187,375,14.60,15
170318045071,3438,2987,451,13.10,13
170318045072,4886,4531,355,7.30,7
170318045073,3762,3455,307,8.20,8
170318045074,466,466,0,0.00,0
170318045081,2469,1384,1085,43.90,44
170318045091,1627,910,717,44.10,44
170318045092,1427,775,652,45.70,46
170318045093,939,356,583,62.10,62
170318045094,1601,634,967,60.40,60
170318045101,1278,589,689,53.90,54
170318045102,1041,169,872,83.80,84
170318045103,2706,636,2070,76.50,77
170318045104,1688,505,1183,70.10,70
170318045111,1811,787,1024,56.50,57
170318045112,832,182,650,78.10,78
170318046031,2320,1291,1029,44.40,44
170318046032,1160,1080,80,6.90,7
170318046033,1805,1609,196,10.90,11
170318046061,751,751,0,0.00,0
170318046062,3042,2869,173,5.70,6
170318046063,1125,998,127,11.30,11
170318046064,2445,2427,18,0.70,1
170318046071,2018,1954,64,3.20,3
170318046072,2368,2300,68,2.90,3
170318046073,1606,1547,59,3.70,4
170318046074,878,844,34,3.90,4
170318046081,1107,1023,84,7.60,8
170318046082,829,664,165,19.90,20
170318046083,1676,1637,39,2.30,2
170318046091,2368,2340,28,1.20,1
170318046092,1534,1318,216,14.10,14
170318046093,1837,1700,137,7.50,8
170318046101,1763,1668,95,5.40,5
170318046102,585,544,41,7.00,7
170318046111,1635,1548,87,5.30,5
170318046112,1741,1701,40,2.30,2
170318046113,1061,1061,0,0.00,0
170318047011,1408,1160,248,17.60,18
170318047012,1398,837,561,40.10,40
170318047013,1227,1183,44,3.60,4
170318047014,2761,1672,1089,39.40,39
170318047051,1048,921,127,12.10,12
170318047052,1874,1416,458,24.40,24
170318047053,1015,970,45,4.40,4
170318047061,1531,1444,87,5.70,6
170318047062,975,937,38,3.90,4
170318047091,1653,1057,596,36.10,36
170318047092,1344,1046,298,22.20,22
170318047093,819,814,5,0.60,1
170318047094,1507,1417,90,6.00,6
170318047095,777,747,30,3.90,4
170318047101,1239,985,254,20.50,21
170318047102,967,816,151,15.60,16
170318047103,1363,1188,175,12.80,13
170318047104,824,759,65,7.90,8
170318047111,3111,2151,960,30.90,31
170318047112,1434,1150,284,19.80,20
170318047113,2657,2430,227,8.50,9
170318047114,889,762,127,14.30,14
170318047121,2118,1340,778,36.70,37
170318047122,834,776,58,7.00,7
170318047123,2657,2636,21,0.80,1
170318047131,1138,1129,9,0.80,1
170318047132,1794,1775,19,1.10,1
170318047133,656,590,66,10.10,10
170318047134,725,725,0,0.00,0
170318047141,798,704,94,11.80,12
170318047142,1234,1074,160,13.00,13
170318047143,1381,1191,190,13.80,14
170318047151,1433,832,601,41.90,42
170318047152,1942,1044,898,46.20,46
170318047161,1255,1196,59,4.70,5
170318047162,2598,2170,428,16.50,17
170318047163,1833,929,904,49.30,49
170318048031,1202,1202,0,0.00,0
170318048032,1321,1293,28,2.10,2
170318048033,3282,3064,218,6.60,7
170318048041,1351,1133,218,16.10,16
170318048042,2510,2386,124,4.90,5
170318048043,1430,583,847,59.20,59
170318048044,1606,1590,16,1.00,1
170318048051,1600,1109,491,30.70,31
170318048052,858,485,373,43.50,44
170318048053,1412,1396,16,1.10,1
170318048054,3173,3134,39,1.20,1
170318048061,744,522,222,29.80,30
170318048062,1176,988,188,16.00,16
170318048063,1971,1316,655,33.20,33
170318048071,867,637,230,26.50,27
170318048072,1034,1034,0,0.00,0
170318048073,1928,1695,233,12.10,12
170318048074,1174,1017,157,13.40,13
170318048081,857,742,115,13.40,13
170318048082,975,824,151,15.50,16
170318048083,723,686,37,5.10,5
170318048091,1431,1421,10,0.70,1
170318048092,1682,1647,35,2.10,2
170318048093,1075,1048,27,2.50,3
170318048101,1062,923,139,13.10,13
170318048102,1281,1192,89,6.90,7
170318048103,2461,2207,254,10.30,10
170318048104,2213,1732,481,21.70,22
170318049011,1849,1762,87,4.70,5
170318049012,719,681,38,5.30,5
170318049013,1489,1420,69,4.60,5
170318049014,725,718,7,1.00,1
170318049015,1119,1095,24,2.10,2
170318049016,433,433,0,0.00,0
170318049021,1334,1223,111,8.30,8
170318049022,1488,1065,423,28.40,28
170318049023,1113,846,267,24.00,24
170318049024,852,852,0,0.00,0
170318049025,966,948,18,1.90,2
170318050011,857,836,21,2.50,3
170318050012,1058,947,111,10.50,11
170318050013,1611,1472,139,8.60,9
170318050014,1330,1241,89,6.70,7
170318050021,1762,1686,76,4.30,4
170318050022,1721,1663,58,3.40,3
170318050023,1129,1070,59,5.20,5
170318050024,1067,581,486,45.50,46
170318050025,968,921,47,4.90,5
170318051051,3033,492,2541,83.80,84
170318051052,1209,1017,192,15.90,16
170318051053,1451,1406,45,3.10,3
170318051054,1575,1197,378,24.00,24
170318051061,1132,1078,54,4.80,5
170318051062,1536,1527,9,0.60,1
170318051071,1906,1202,704,36.90,37
170318051072,1402,1163,239,17.00,17
170318051073,962,948,14,1.50,2
170318051074,2154,1215,939,43.60,44
170318051075,529,413,116,21.90,22
170318051081,3375,854,2521,74.70,75
170318051082,2009,1867,142,7.10,7
170318051083,860,845,15,1.70,2
170318051084,900,630,270,30.00,30
170318051091,1344,1338,6,0.40,0
170318051092,1852,1789,63,3.40,3
170318051093,1126,1107,19,1.70,2
170318051101,2258,2189,69,3.10,3
170318051102,933,933,0,0.00,0
170318051103,332,316,16,4.80,5
170318051104,691,645,46,6.70,7
170318051111,1127,1093,34,3.00,3
170318051112,868,845,23,2.60,3
170318051113,2550,1974,576,22.60,23
170318051114,1322,319,1003,75.90,76
170318051115,837,232,605,72.30,72
170318051116,844,710,134,15.90,16
170318051121,1575,1393,182,11.60,12
170318051122,1372,1269,103,7.50,8
170318052011,963,955,8,0.80,1
170318052012,867,757,110,12.70,13
170318052013,1485,1409,76,5.10,5
170318052021,913,836,77,8.40,8
170318052022,549,485,64,11.70,12
170318052023,1456,1247,209,14.40,14
170318052024,1107,1075,32,2.90,3
170318053011,893,874,19,2.10,2
170318053012,1654,1420,234,14.10,14
170318053013,689,680,9,1.30,1
170318053021,943,943,0,0.00,0
170318053022,1239,1129,110,8.90,9
170318053023,1337,1329,8,0.60,1
170318054011,1378,1206,172,12.50,13
170318054012,1417,1262,155,10.90,11
170318054013,1052,1042,10,1.00,1
170318054021,855,838,17,2.00,2
170318054022,904,818,86,9.50,10
170318054023,732,732,0,0.00,0
170318054024,1701,1241,460,27.00,27
170318054025,598,598,0,0.00,0
170318055011,1207,1130,77,6.40,6
170318055012,1647,1513,134,8.10,8
170318055013,905,905,0,0.00,0
170318055021,1109,1009,100,9.00,9
170318055022,808,762,46,5.70,6
170318055023,1067,971,96,9.00,9
170318055024,963,955,8,0.80,1
170318056001,1361,1244,117,8.60,9
170318056002,1127,1115,12,1.10,1
170318056003,1107,1102,5,0.50,1
170318056004,1084,1066,18,1.70,2
170318057011,1095,1065,30,2.70,3
170318057012,478,437,41,8.60,9
170318057013,1408,1134,274,19.50,20
170318057014,1210,1159,51,4.20,4
170318057015,960,881,79,8.20,8
170318057021,1154,1105,49,4.20,4
170318057022,745,728,17,2.30,2
170318058011,925,925,0,0.00,0
170318058012,750,750,0,0.00,0
170318058013,710,690,20,2.80,3
170318058021,899,823,76,8.50,9
170318058022,716,697,19,2.70,3
170318058023,1279,1258,21,1.60,2
170318058024,1189,1050,139,11.70,12
170318058025,856,708,148,17.30,17
170318059011,1599,1508,91,5.70,6
170318059012,1579,1514,65,4.10,4
170318059013,890,710,180,20.20,20
170318059021,966,966,0,0.00,0
170318059022,1223,1161,62,5.10,5
170318059023,824,711,113,13.70,14
170318059024,1763,1668,95,5.40,5
170318059025,424,424,0,0.00,0
170318059026,1248,1138,110,8.80,9
170318060011,1013,947,66,6.50,7
170318060012,2340,2008,332,14.20,14
170318060013,2058,1718,340,16.50,17
170318060014,852,724,128,15.00,15
170318060021,883,659,224,25.40,25
170318060022,2570,2370,200,7.80,8
170318060023,1708,1679,29,1.70,2
170318060024,1213,936,277,22.80,23
170318060025,1388,1086,302,21.80,22
170318060031,1384,1384,0,0.00,0
170318060032,1716,724,992,57.80,58
170318060033,979,964,15,1.50,2
170318060034,849,849,0,0.00,0
170318060035,1480,1454,26,1.80,2
170318060036,1244,1227,17,1.40,1
170318060041,1884,1650,234,12.40,12
170318060042,2621,2078,543,20.70,21
170318060043,1915,1552,363,19.00,19
170318060044,1251,906,345,27.60,28
170318061021,2126,1678,448,21.10,21
170318061022,1049,960,89,8.50,9
170318061023,965,914,51,5.30,5
170318061031,1710,1612,98,5.70,6
170318061032,924,753,171,18.50,19
170318061033,1415,1329,86,6.10,6
170318061034,1259,1259,0,0.00,0
170318061041,1875,1316,559,29.80,30
170318061042,1224,1193,31,2.50,3
170318061043,1842,1681,161,8.70,9
170318062011,3033,2503,530,17.50,18
170318062012,1516,1242,274,18.10,18
170318062021,559,553,6,1.10,1
170318062022,1815,1573,242,13.30,13
170318062023,2060,1926,134,6.50,7
170318063001,1023,849,174,17.00,17
170318063002,964,742,222,23.00,23
170318063003,582,454,128,22.00,22
170318063004,598,552,46,7.70,8
170318063005,776,634,142,18.30,18
170318063006,900,749,151,16.80,17
170318064001,1145,1019,126,11.00,11
170318064002,1314,940,374,28.50,29
170318065011,1076,742,334,31.00,31
170318065012,1443,774,669,46.40,46
170318065021,923,738,185,20.00,20
170318065022,544,460,84,15.40,15
170318065023,916,757,159,17.40,17
170318065024,1989,761,1228,61.70,62
170318066001,1892,1477,415,21.90,22
170318066002,1544,953,591,38.30,38
170318067001,1639,1467,172,10.50,11
170318067002,1140,1081,59,5.20,5
170318067003,984,966,18,1.80,2
170318067004,454,384,70,15.40,15
170318068011,831,695,136,16.40,16
170318068012,1498,1469,29,1.90,2
170318068013,971,874,97,10.00,10
170318068014,578,522,56,9.70,10
170318068021,900,822,78,8.70,9
170318068022,1186,1126,60,5.10,5
170318068023,879,771,108,12.30,12
170318069001,672,511,161,24.00,24
170318069002,1875,1856,19,1.00,1
170318069003,2138,2009,129,6.00,6
170318070001,2903,2695,208,7.20,7
170318070002,1074,985,89,8.30,8
170318070003,1204,1129,75,6.20,6
170318070004,743,718,25,3.40,3
170318071001,685,640,45,6.60,7
170318071002,1272,1194,78,6.10,6
170318071003,1695,1656,39,2.30,2
170318072001,891,882,9,1.00,1
170318072002,2001,1534,467,23.30,23
170318072003,947,947,0,0.00,0
170318072004,1029,682,347,33.70,34
170318072005,968,968,0,0.00,0
170318073001,2296,2153,143,6.20,6
170318073002,1434,1420,14,1.00,1
170318073003,1383,1300,83,6.00,6
170318073004,795,699,96,12.10,12
170318073005,1517,1347,170,11.20,11
170318074001,748,563,185,24.70,25
170318074002,1323,994,329,24.90,25
170318074003,2583,2062,521,20.20,20
170318074004,1016,1016,0,0.00,0
170318074005,1166,1125,41,3.50,4
170318075001,1287,1146,141,11.00,11
170318075002,1115,1032,83,7.40,7
170318075003,1035,845,190,18.40,18
170318076001,1265,1151,114,9.00,9
170318076002,1564,1540,24,1.50,2
170318076003,927,684,243,26.20,26
170318076004,1183,1101,82,6.90,7
170318076005,1427,1159,268,18.80,19
170318077001,2276,1834,442,19.40,19
170318077002,1455,949,506,34.80,35
170318077003,1017,962,55,5.40,5
170318077004,1491,1405,86,5.80,6
170318078001,1394,1325,69,4.90,5
170318078002,1361,1044,317,23.30,23
170318079001,1465,1362,103,7.00,7
170318079002,1428,1224,204,14.30,14
170318079003,1181,978,203,17.20,17
170318080011,1133,1030,103,9.10,9
170318080012,1115,1054,61,5.50,6
170318080013,1643,1535,108,6.60,7
170318080021,1261,1250,11,0.90,1
170318080022,1286,1278,8,0.60,1
170318080023,1618,1542,76,4.70,5
170318080024,523,468,55,10.50,11
170318081001,1487,1400,87,5.90,6
170318081002,2065,1799,266,12.90,13
170318082001,2224,2044,180,8.10,8
170318082002,1639,1600,39,2.40,2
170318082003,1737,1626,111,6.40,6
170318083011,1164,1151,13,1.10,1
170318083012,2771,2500,271,9.80,10
170318083013,985,956,29,2.90,3
170318083014,1003,990,13,1.30,1
170318083021,1367,1190,177,12.90,13
170318083022,1996,1915,81,4.10,4
170318083023,584,584,0,0.00,0
170318084001,1823,1701,122,6.70,7
170318084002,1136,872,264,23.20,23
170318084003,1428,1419,9,0.60,1
170318085001,1437,1423,14,1.00,1
170318085002,638,638,0,0.00,0
170318085003,1064,1019,45,4.20,4
170318085004,933,808,125,13.40,13
170318086001,1200,1157,43,3.60,4
170318086002,860,805,55,6.40,6
170318087021,2924,2645,279,9.50,10
170318087022,2677,2435,242,9.00,9
170318088001,1676,1545,131,7.80,8
170318088002,2017,1906,111,5.50,6
170318089001,1421,1252,169,11.90,12
170318089002,689,658,31,4.50,5
170318089003,1904,1865,39,2.00,2
170318090001,690,681,9,1.30,1
170318090002,981,967,14,1.40,1
170318090003,1506,1462,44,2.90,3
170318090004,987,987,0,0.00,0
170318091001,1103,1050,53,4.80,5
170318091002,925,905,20,2.20,2
170318091003,1317,1314,3,0.20,0
170318092001,1276,1149,127,10.00,10
170318092002,918,911,7,0.80,1
170318092003,1389,698,691,49.70,50
170318092004,1570,1265,305,19.40,19
170318093001,851,826,25,2.90,3
170318093002,1889,1661,228,12.10,12
170318093003,1789,1537,252,14.10,14
170318094001,879,879,0,0.00,0
170318094002,1604,1537,67,4.20,4
170318094003,1246,1202,44,3.50,4
170318094004,1465,1394,71,4.80,5
170318095001,1289,1258,31,2.40,2
170318095002,1478,1360,118,8.00,8
170318095003,779,705,74,9.50,10
170318096001,842,842,0,0.00,0
170318096002,1812,1465,347,19.20,19
170318096003,829,662,167,20.10,20
170318097001,1212,1009,203,16.70,17
170318097002,2147,1062,1085,50.50,51
170318097003,612,602,10,1.60,2
170318098001,739,731,8,1.10,1
170318098002,2286,1996,290,12.70,13
170318099001,3009,2922,87,2.90,3
170318100001,1949,1901,48,2.50,3
170318100002,1717,1664,53,3.10,3
170318100003,1259,1245,14,1.10,1
170318101001,645,520,125,19.40,19
170318101002,1142,1142,0,0.00,0
170318101003,1048,775,273,26.00,26
170318101004,484,370,114,23.60,24
170318101005,1504,1259,245,16.30,16
170318102001,967,792,175,18.10,18
170318102002,1073,1064,9,0.80,1
170318102003,1191,1151,40,3.40,3
170318102004,1354,1248,106,7.80,8
170318102005,515,421,94,18.30,18
170318102006,839,776,63,7.50,8
170318103011,950,787,163,17.20,17
170318103012,927,679,248,26.80,27
170318103013,994,813,181,18.20,18
170318103014,737,588,149,20.20,20
170318103021,1357,1336,21,1.50,2
170318103022,1071,959,112,10.50,11
170318103023,832,826,6,0.70,1
170318104001,777,777,0,0.00,0
170318104002,1141,1027,114,10.00,10
170318104003,2491,2178,313,12.60,13
170318104004,972,916,56,5.80,6
170318105011,812,775,37,4.60,5
170318105012,976,936,40,4.10,4
170318105013,827,821,6,0.70,1
170318105014,1128,888,240,21.30,21
170318105015,1362,1173,189,13.90,14
170318105021,648,648,0,0.00,0
170318105022,950,842,108,11.40,11
170318105023,1811,1672,139,7.70,8
170318105024,864,758,106,12.30,12
170318105025,791,736,55,7.00,7
170318106001,1467,1131,336,22.90,23
170318106002,1926,1754,172,8.90,9
170318106003,1325,1188,137,10.30,10
170318107011,1500,1066,434,28.90,29
170318107012,1296,796,500,38.60,39
170318107013,1175,718,457,38.90,39
170318107014,1075,855,220,20.50,21
170318107021,1585,1327,258,16.30,16
170318107022,587,424,163,27.80,28
170318107023,1798,1364,434,24.10,24
170318108001,922,600,322,34.90,35
170318108002,1779,1438,341,19.20,19
170318108003,1641,1257,384,23.40,23
170318108004,1173,1027,146,12.40,12
170318109001,1752,1039,713,40.70,41
170318109002,1811,1682,129,7.10,7
170318109003,741,668,73,9.90,10
170318109004,703,476,227,32.30,32
170318109005,1241,735,506,40.80,41
170318110001,688,623,65,9.40,9
170318110002,947,754,193,20.40,20
170318110003,775,658,117,15.10,15
170318110004,887,809,78,8.80,9
170318110005,884,720,164,18.60,19
170318111001,319,233,86,27.00,27
170318111002,1600,1417,183,11.40,11
170318111003,1043,1012,31,3.00,3
170318111004,1172,590,582,49.70,50
170318111005,2027,1809,218,10.80,11
170318112001,921,492,429,46.60,47
170318112002,1696,1299,397,23.40,23
170318112003,1172,954,218,18.60,19
170318112004,1003,753,250,24.90,25
170318112005,916,300,616,67.20,67
170318113011,1412,686,726,51.40,51
170318113012,928,338,590,63.60,64
170318113013,1479,580,899,60.80,61
170318113014,1381,700,681,49.30,49
170318113021,1129,518,611,54.10,54
170318113022,2446,616,1830,74.80,75
170318114011,896,391,505,56.40,56
170318114012,1059,759,300,28.30,28
170318114013,850,697,153,18.00,18
170318114014,1363,479,884,64.90,65
170318114015,1009,523,486,48.20,48
170318114021,1360,869,491,36.10,36
170318114022,1512,703,809,53.50,54
170318114023,1567,957,610,38.90,39
170318115001,1821,1190,631,34.70,35
170318115002,1537,960,577,37.50,38
170318115003,1047,566,481,45.90,46
170318115004,1578,936,642,40.70,41
170318116001,1440,986,454,31.50,32
170318116002,1487,1020,467,31.40,31
170318116003,1859,1232,627,33.70,34
170318116004,1196,1120,76,6.40,6
170318117011,2765,1125,1640,59.30,59
170318117012,1066,125,941,88.30,88
170318117021,963,471,492,51.10,51
170318117022,1496,605,891,59.60,60
170318117023,2194,1409,785,35.80,36
170318118001,1126,520,606,53.80,54
170318118002,2042,798,1244,60.90,61
170318118003,1029,629,400,38.90,39
170318118004,1364,568,796,58.40,58
170318119001,882,819,63,7.10,7
170318119002,1380,1326,54,3.90,4
170318119003,1293,1284,9,0.70,1
170318119004,2380,2332,48,2.00,2
170318120001,732,610,122,16.70,17
170318120002,645,645,0,0.00,0
170318120003,1308,1157,151,11.50,12
170318120004,796,786,10,1.30,1
170318120005,848,848,0,0.00,0
170318120006,947,883,64,6.80,7
170318121001,1149,1033,116,10.10,10
170318121002,741,698,43,5.80,6
170318121003,1130,1085,45,4.00,4
170318121004,725,713,12,1.70,2
170318121005,606,474,132,21.80,22
170318122001,1191,1140,51,4.30,4
170318122002,814,794,20,2.50,3
170318122003,1302,1213,89,6.80,7
170318122004,855,843,12,1.40,1
170318123011,591,584,7,1.20,1
170318123012,1649,1447,202,12.20,12
170318123013,1297,968,329,25.40,25
170318123021,728,617,111,15.20,15
170318123022,1078,1030,48,4.50,5
170318123023,1046,1015,31,3.00,3
170318124001,1136,1118,18,1.60,2
170318124002,1170,1158,12,1.00,1
170318124003,1244,1180,64,5.10,5
170318125001,1063,921,142,13.40,13
170318125002,808,739,69,8.50,9
170318125003,970,839,131,13.50,14
170318125004,867,824,43,5.00,5
170318126001,496,470,26,5.20,5
170318126002,898,887,11,1.20,1
170318126003,1148,1021,127,11.10,11
170318126004,853,747,106,12.40,12
170318127001,918,849,69,7.50,8
170318127002,887,817,70,7.90,8
170318127003,1350,1261,89,6.60,7
170318128011,1847,1736,111,6.00,6
170318128012,922,893,29,3.10,3
170318128021,609,579,30,4.90,5
170318128022,963,853,110,11.40,11
170318128023,1141,879,262,23.00,23
170318129001,806,806,0,0.00,0
170318129002,1262,1232,30,2.40,2
170318129003,1422,1315,107,7.50,8
170318129004,1547,1462,85,5.50,6
170318130001,619,619,0,0.00,0
170318130002,910,888,22,2.40,2
170318130003,589,532,57,9.70,10
170318130004,868,775,93,10.70,11
170318130005,429,381,48,11.20,11
170318131001,938,889,49,5.20,5
170318131002,787,728,59,7.50,8
170318131003,923,872,51,5.50,6
170318131004,821,707,114,13.90,14
170318131005,1330,1214,116,8.70,9
170318132001,814,814,0,0.00,0
170318132002,674,674,0,0.00,0
170318132003,1144,1126,18,1.60,2
170318132004,892,820,72,8.10,8
170318132005,1021,960,61,6.00,6
170318133011,1999,226,1773,88.70,89
170318133012,698,182,516,73.90,74
170318133013,734,74,660,89.90,90
170318133021,1826,68,1758,96.30,96
170318133022,1946,246,1700,87.40,87
170318134001,1698,200,1498,88.20,88
170318134002,993,374,619,62.30,62
170318134003,783,56,727,92.80,93
170318134004,1983,285,1698,85.60,86
170318134005,915,91,824,90.10,90
170318134006,1542,54,1488,96.50,97
170318135001,1294,227,1067,82.50,83
170318135002,1743,248,1495,85.80,86
170318135003,448,183,265,59.20,59
170318135004,2503,173,2330,93.10,93
170318135005,2215,367,1848,83.40,83
170318136001,996,166,830,83.30,83
170318136002,1776,9,1767,99.50,100
170318136003,2440,122,2318,95.00,95
170318137011,2112,181,1931,91.40,91
170318137012,1353,181,1172,86.60,87
170318137021,954,274,680,71.30,71
170318137022,606,0,606,100.00,100
170318137023,1222,291,931,76.20,76
170318137024,1268,135,1133,89.40,89
170318138011,670,14,656,97.90,98
170318138012,1260,25,1235,98.00,98
170318138013,1190,117,1073,90.20,90
170318138021,967,100,867,89.70,90
170318138022,1181,142,1039,88.00,88
170318138023,1495,86,1409,94.20,94
170318138024,1600,151,1449,90.60,91
170318139001,2062,155,1907,92.50,93
170318139002,1501,124,1377,91.70,92
170318139003,1100,131,969,88.10,88
170318139004,685,98,587,85.70,86
170318139005,1118,169,949,84.90,85
170318140001,1063,292,771,72.50,73
170318140002,1457,260,1197,82.20,82
170318140003,1628,248,1380,84.80,85
170318140004,989,164,825,83.40,83
170318141001,2561,95,2466,96.30,96
170318141002,950,116,834,87.80,88
170318141003,795,63,732,92.10,92
170318142001,2182,235,1947,89.20,89
170318142002,384,58,326,84.90,85
170318142003,1182,164,1018,86.10,86
170318142004,1134,84,1050,92.60,93
170318142005,970,46,924,95.30,95
170318142006,956,42,914,95.60,96
170318143001,1861,161,1700,91.30,91
170318143002,2747,207,2540,92.50,93
170318144001,1242,212,1030,82.90,83
170318144002,1547,382,1165,75.30,75
170318144003,1724,532,1192,69.10,69
170318144004,876,147,729,83.20,83
170318144005,1676,237,1439,85.90,86
170318144006,544,69,475,87.30,87
170318145001,1958,457,1501,76.70,77
170318145002,1448,83,1365,94.30,94
170318145003,1673,326,1347,80.50,81
170318146001,1076,481,595,55.30,55
170318146002,977,316,661,67.70,68
170318146003,1219,212,1007,82.60,83
170318146004,1119,398,721,64.40,64
170318146005,959,585,374,39.00,39
170318147001,1185,260,925,78.10,78
170318147002,1468,469,999,68.10,68
170318147003,1196,363,833,69.60,70
170318147004,1181,383,798,67.60,68
170318147005,1208,636,572,47.40,47
170318148001,1729,944,785,45.40,45
170318148002,1751,753,998,57.00,57
170318148003,713,304,409,57.40,57
170318148004,937,260,677,72.30,72
170318148005,781,429,352,45.10,45
170318149001,1064,387,677,63.60,64
170318149002,1503,833,670,44.60,45
170318149003,2156,1018,1138,52.80,53
170318149004,1988,977,1011,50.90,51
170318150001,765,164,601,78.60,79
170318150002,1363,439,924,67.80,68
170318150003,2179,940,1239,56.90,57
170318151001,1399,309,1090,77.90,78
170318151002,1069,326,743,69.50,70
170318151003,1776,888,888,50.00,50
170318152001,1421,543,878,61.80,62
170318152002,1592,348,1244,78.10,78
170318152003,987,724,263,26.60,27
170318152004,666,289,377,56.60,57
170318152005,1711,500,1211,70.80,71
170318153001,1436,305,1131,78.80,79
170318153002,902,333,569,63.10,63
170318153003,698,464,234,33.50,34
170318153004,809,568,241,29.80,30
170318154001,988,618,370,37.40,37
170318154002,1169,362,807,69.00,69
170318154003,2234,1440,794,35.50,36
170318154004,1265,883,382,30.20,30
170318155001,1517,786,731,48.20,48
170318155002,876,380,496,56.60,57
170318155003,1398,271,1127,80.60,81
170318155004,1274,437,837,65.70,66
170318155005,1270,340,930,73.20,73
170318155006,926,182,744,80.30,80
170318155007,862,343,519,60.20,60
170318156001,826,381,445,53.90,54
170318156002,1154,829,325,28.20,28
170318156003,1346,845,501,37.20,37
170318156004,828,691,137,16.50,17
170318156005,966,795,171,17.70,18
170318157011,1281,1067,214,16.70,17
170318157012,844,844,0,0.00,0
170318157013,823,823,0,0.00,0
170318157014,924,719,205,22.20,22
170318157021,568,440,128,22.50,23
170318157022,911,740,171,18.80,19
170318157023,1482,1132,350,23.60,24
170318157024,631,604,27,4.30,4
170318157025,1481,1130,351,23.70,24
170318158001,1557,1454,103,6.60,7
170318159001,1375,1318,57,4.10,4
170318159002,1350,1244,106,7.90,8
170318159003,1868,1771,97,5.20,5
170318160001,1285,1265,20,1.60,2
170318160002,1079,969,110,10.20,10
170318160003,1032,888,144,14.00,14
170318161001,531,488,43,8.10,8
170318161002,1197,925,272,22.70,23
170318161003,1168,766,402,34.40,34
170318161004,790,608,182,23.00,23
170318161005,1232,1183,49,4.00,4
170318161006,1295,1111,184,14.20,14
170318162001,1527,945,582,38.10,38
170318162002,622,330,292,46.90,47
170318162003,1305,953,352,27.00,27
170318163001,1003,350,653,65.10,65
170318163002,1888,453,1435,76.00,76
170318163003,1446,437,1009,69.80,70
170318163004,1014,270,744,73.40,73
170318164011,1173,257,916,78.10,78
170318164012,911,105,806,88.50,89
170318164013,1352,303,1049,77.60,78
170318164014,1656,50,1606,97.00,97
170318164021,1420,492,928,65.40,65
170318164022,1751,78,1673,95.50,96
170318164023,903,147,756,83.70,84
170318164024,595,99,496,83.40,83
170318165001,1605,172,1433,89.30,89
170318165002,2175,313,1862,85.60,86
170318165003,795,289,506,63.60,64
170318166001,1278,108,1170,91.50,92
170318166002,1338,116,1222,91.30,91
170318166003,2154,169,1985,92.20,92
170318167001,935,237,698,74.70,75
170318167002,1897,275,1622,85.50,86
170318168001,1380,750,630,45.70,46
170318168002,1952,1484,468,24.00,24
170318168003,1237,1022,215,17.40,17
170318168004,795,586,209,26.30,26
170318169001,1233,920,313,25.40,25
170318169002,1478,1161,317,21.40,21
170318169003,1073,637,436,40.60,41
170318169004,2111,1532,579,27.40,27
170318170001,654,584,70,10.70,11
170318170002,473,362,111,23.50,24
170318170003,741,534,207,27.90,28
170318170004,1693,1223,470,27.80,28
170318170005,1493,1344,149,10.00,10
170318171011,1009,937,72,7.10,7
170318171012,981,981,0,0.00,0
170318171013,1405,1263,142,10.10,10
170318171014,1308,1296,12,0.90,1
170318171021,1002,933,69,6.90,7
170318171022,979,939,40,4.10,4
170318171023,1487,1180,307,20.60,21
170318172001,2170,1603,567,26.10,26
170318172002,1135,1075,60,5.30,5
170318172003,787,787,0,0.00,0
170318172004,412,412,0,0.00,0
170318173001,2377,1813,564,23.70,24
170318174001,1039,506,533,51.30,51
170318174002,1102,644,458,41.60,42
170318174003,2140,658,1482,69.30,69
170318175001,658,621,37,5.60,6
170318175002,852,852,0,0.00,0
170318175003,1409,920,489,34.70,35
170318175004,992,760,232,23.40,23
170318176001,1325,1246,79,6.00,6
170318176002,1334,1157,177,13.30,13
170318176003,1215,1088,127,10.50,11
170318177001,904,832,72,8.00,8
170318177002,1592,1384,208,13.10,13
170318177003,1613,1493,120,7.40,7
170318177004,1092,1031,61,5.60,6
170318179001,1426,1426,0,0.00,0
170318179002,1351,1122,229,17.00,17
170318179003,1101,932,169,15.30,15
170318179004,858,858,0,0.00,0
170318179005,746,673,73,9.80,10
170318180001,1822,1763,59,3.20,3
170318180002,1058,858,200,18.90,19
170318180003,1571,1294,277,17.60,18
170318181001,1144,1063,81,7.10,7
170318181002,1273,1033,240,18.90,19
170318182001,1391,984,407,29.30,29
170318182002,759,635,124,16.30,16
170318182003,509,429,80,15.70,16
170318182004,1895,1541,354,18.70,19
170318183001,1531,1074,457,29.80,30
170318183002,1708,1077,631,36.90,37
170318183003,1991,1081,910,45.70,46
170318183004,1097,886,211,19.20,19
170318184011,1021,478,543,53.20,53
170318184012,523,513,10,1.90,2
170318184013,1117,911,206,18.40,18
170318184014,764,746,18,2.40,2
170318184021,949,728,221,23.30,23
170318184022,912,634,278,30.50,31
170318184023,1224,1077,147,12.00,12
170318185001,1294,1151,143,11.10,11
170318185002,1393,1130,263,18.90,19
170318185003,1998,1884,114,5.70,6
170318185004,872,792,80,9.20,9
170318186001,1323,1013,310,23.40,23
170318186002,2104,1951,153,7.30,7
170318186003,1346,1118,228,16.90,17
170318187001,813,651,162,19.90,20
170318187002,716,708,8,1.10,1
170318187003,1189,1044,145,12.20,12
170318187004,857,670,187,21.80,22
170318188001,1044,903,141,13.50,14
170318188002,654,611,43,6.60,7
170318188003,831,662,169,20.30,20
170318188004,745,669,76,10.20,10
170318188005,1331,1121,210,15.80,16
170318188006,1025,803,222,21.70,22
170318189001,1728,1263,465,26.90,27
170318189002,1988,1829,159,8.00,8
170318189003,1035,958,77,7.40,7
170318190001,712,712,0,0.00,0
170318190002,1420,1354,66,4.60,5
170318190003,1393,1125,268,19.20,19
170318190004,1070,1070,0,0.00,0
170318191001,1262,654,608,48.20,48
170318191002,854,407,447,52.30,52
170318191003,1201,593,608,50.60,51
170318191004,1041,703,338,32.50,33
170318192001,739,412,327,44.20,44
170318192002,1588,891,697,43.90,44
170318192003,2587,1507,1080,41.70,42
170318192004,1469,696,773,52.60,53
170318193001,867,756,111,12.80,13
170318193002,1552,1295,257,16.60,17
170318193003,609,609,0,0.00,0
170318194001,1174,927,247,21.00,21
170318194002,1382,1016,366,26.50,27
170318194003,769,531,238,30.90,31
170318194004,1219,915,304,24.90,25
170318194005,688,538,150,21.80,22
170318195001,594,594,0,0.00,0
170318195002,541,499,42,7.80,8
170318195003,894,695,199,22.30,22
170318195004,1090,862,228,20.90,21
170318196001,672,672,0,0.00,0
170318196002,1040,1008,32,3.10,3
170318196003,1041,910,131,12.60,13
170318196004,1096,1037,59,5.40,5
170318197001,1388,1378,10,0.70,1
170318197002,2198,2169,29,1.30,1
170318197003,1548,1540,8,0.50,1
170318197004,851,851,0,0.00,0
170318198011,961,961,0,0.00,0
170318198012,896,885,11,1.20,1
170318198013,1686,1559,127,7.50,8
170318198014,582,582,0,0.00,0
170318198015,1280,1179,101,7.90,8
170318198021,1304,1269,35,2.70,3
170318198022,1333,1270,63,4.70,5
170318199001,998,978,20,2.00,2
170318199002,1310,1279,31,2.40,2
170318199003,1108,1020,88,7.90,8
170318200001,1021,864,157,15.40,15
170318200002,987,965,22,2.20,2
170318201011,868,868,0,0.00,0
170318201012,1163,1163,0,0.00,0
170318201013,1062,1060,2,0.20,0
170318201014,550,550,0,0.00,0
170318201015,842,842,0,0.00,0
170318201016,1682,1633,49,2.90,3
170318201017,1248,1227,21,1.70,2
170318201031,656,553,103,15.70,16
170318201032,692,616,76,11.00,11
170318201033,1670,848,822,49.20,49
170318201034,971,927,44,4.50,5
170318201041,1222,914,308,25.20,25
170318201042,877,761,116,13.20,13
170318201043,955,900,55,5.80,6
170318201044,1069,995,74,6.90,7
170318202011,1772,1603,169,9.50,10
170318202012,1990,1810,180,9.00,9
170318202013,1207,1207,0,0.00,0
170318202014,3118,2928,190,6.10,6
170318202021,2188,1142,1046,47.80,48
170318202022,989,787,202,20.40,20
170318202023,430,418,12,2.80,3
170318203001,1602,640,962,60.00,60
170318203002,1294,506,788,60.90,61
170318203003,1083,516,567,52.40,52
170318203004,1224,466,758,61.90,62
170318204001,1356,417,939,69.20,69
170318204002,2005,321,1684,84.00,84
170318204003,2803,895,1908,68.10,68
170318205011,772,518,254,32.90,33
170318205012,1143,907,236,20.60,21
170318205013,1052,904,148,14.10,14
170318205014,1610,1213,397,24.70,25
170318205015,1683,1443,240,14.30,14
170318205021,1632,1203,429,26.30,26
170318205022,943,931,12,1.30,1
170318205023,1085,1031,54,5.00,5
170318205024,1432,1297,135,9.40,9
170318206031,1098,994,104,9.50,10
170318206032,2253,1795,458,20.30,20
170318206033,1926,1299,627,32.60,33
170318206041,3329,2881,448,13.50,14
170318206042,823,749,74,9.00,9
170318206051,1243,1093,150,12.10,12
170318206052,1392,1033,359,25.80,26
170318206053,1534,1504,30,2.00,2
170318206061,1549,1393,156,10.10,10
170318206062,2199,2098,101,4.60,5
170318207001,1749,808,941,53.80,54
170318207002,926,469,457,49.40,49
170318207003,1827,1100,727,39.80,40
170318207004,2308,1175,1133,49.10,49
170318208001,1993,684,1309,65.70,66
170318208002,1488,945,543,36.50,37
170318208003,742,482,260,35.00,35
170318209011,2172,1765,407,18.70,19
170318209012,1104,1003,101,9.10,9
170318209013,1161,384,777,66.90,67
170318209014,1025,693,332,32.40,32
170318209021,925,389,536,57.90,58
170318209022,1381,820,561,40.60,41
170318209023,1189,797,392,33.00,33
170318209024,1279,907,372,29.10,29
170318210011,1380,953,427,30.90,31
170318210012,1523,1151,372,24.40,24
170318210013,1314,1268,46,3.50,4
170318210014,1070,900,170,15.90,16
170318210021,1109,885,224,20.20,20
170318210022,1169,833,336,28.70,29
170318210023,676,620,56,8.30,8
170318210024,1116,812,304,27.20,27
170318210025,1625,1214,411,25.30,25
170318211011,1189,853,336,28.30,28
170318211012,798,659,139,17.40,17
170318211013,968,630,338,34.90,35
170318211014,1593,1345,248,15.60,16
170318211021,1239,682,557,45.00,45
170318211022,1206,949,257,21.30,21
170318211023,1208,749,459,38.00,38
170318211024,538,502,36,6.70,7
170318212001,1154,807,347,30.10,30
170318212002,1332,473,859,64.50,65
170318212003,2307,1214,1093,47.40,47
170318212004,1447,1267,180,12.40,12
170318213001,638,540,98,15.40,15
170318213002,2571,1512,1059,41.20,41
170318213003,541,436,105,19.40,19
170318213004,1738,254,1484,85.40,85
170318214011,825,676,149,18.10,18
170318214012,436,405,31,7.10,7
170318214013,800,800,0,0.00,0
170318214014,1371,1258,113,8.20,8
170318214021,1474,1474,0,0.00,0
170318214022,1586,1586,0,0.00,0
170318214023,658,615,43,6.50,7
170318215001,2020,1970,50,2.50,3
170318216001,1141,875,266,23.30,23
170318216002,877,782,95,10.80,11
170318216003,722,683,39,5.40,5
170318216004,1350,1149,201,14.90,15
170318216005,413,305,108,26.20,26
170318217001,553,498,55,9.90,10
170318217002,1502,1295,207,13.80,14
170318217003,1106,1106,0,0.00,0
170318217004,1038,1038,0,0.00,0
170318217005,656,604,52,7.90,8
170318218001,956,668,288,30.10,30
170318218002,779,667,112,14.40,14
170318218003,542,435,107,19.70,20
170318218004,995,951,44,4.40,4
170318218005,1244,1001,243,19.50,20
170318218006,912,912,0,0.00,0
170318219001,1160,926,234,20.20,20
170318219002,851,823,28,3.30,3
170318219003,1302,1133,169,13.00,13
170318219004,857,835,22,2.60,3
170318219005,968,967,1,0.10,0
170318220001,910,900,10,1.10,1
170318220002,504,403,101,20.00,20
170318220003,1129,945,184,16.30,16
170318220004,777,657,120,15.40,15
170318220005,1038,609,429,41.30,41
170318221011,1294,916,378,29.20,29
170318221012,1199,982,217,18.10,18
170318221013,849,822,27,3.20,3
170318221014,1087,946,141,13.00,13
170318221021,1451,749,702,48.40,48
170318221022,1419,1169,250,17.60,18
170318221023,1280,914,366,28.60,29
170318221024,602,376,226,37.50,38
170318222001,2213,1701,512,23.10,23
170318222002,974,789,185,19.00,19
170318222003,599,573,26,4.30,4
170318223011,1092,838,254,23.30,23
170318223012,769,714,55,7.20,7
170318223013,766,697,69,9.00,9
170318223014,1492,1301,191,12.80,13
170318223021,1591,1493,98,6.20,6
170318223022,859,669,190,22.10,22
170318223023,1155,818,337,29.20,29
170318223024,925,840,85,9.20,9
170318224001,1372,866,506,36.90,37
170318224002,2176,2080,96,4.40,4
170318224003,2594,2317,277,10.70,11
170318224004,533,533,0,0.00,0
170318225001,1023,920,103,10.10,10
170318225002,868,868,0,0.00,0
170318225003,1245,1012,233,18.70,19
170318225004,1288,1050,238,18.50,19
170318226011,1936,1434,502,25.90,26
170318226012,1841,1791,50,2.70,3
170318226013,778,708,70,9.00,9
170318226021,1374,1043,331,24.10,24
170318226022,3016,2812,204,6.80,7
170318226023,2884,2783,101,3.50,4
170318227011,1355,1193,162,12.00,12
170318227012,1038,861,177,17.10,17
170318227013,646,521,125,19.30,19
170318227014,1109,658,451,40.70,41
170318227021,1856,1756,100,5.40,5
170318227022,762,483,279,36.60,37
170318227023,572,572,0,0.00,0
170318228011,1978,1632,346,17.50,18
170318228012,1495,1183,312,20.90,21
170318228021,1570,1473,97,6.20,6
170318228022,899,546,353,39.30,39
170318228023,1105,971,134,12.10,12
170318229001,1974,1523,451,22.80,23
170318230011,1648,1498,150,9.10,9
170318230012,1002,806,196,19.60,20
170318230013,1100,912,188,17.10,17
170318230014,1143,900,243,21.30,21
170318230015,1116,902,214,19.20,19
170318230021,1296,1142,154,11.90,12
170318230022,1076,1034,42,3.90,4
170318230023,2054,1583,471,22.90,23
170318230024,1619,1321,298,18.40,18
170318231011,907,699,208,22.90,23
170318231012,881,837,44,5.00,5
170318231013,568,539,29,5.10,5
170318231014,835,817,18,2.20,2
170318231015,1204,1010,194,16.10,16
170318231021,2169,2077,92,4.20,4
170318231022,1553,1490,63,4.10,4
170318232001,2204,2091,113,5.10,5
170318232002,2445,2169,276,11.30,11
170318233021,1829,1487,342,18.70,19
170318233022,2696,1436,1260,46.70,47
170318233023,1709,1451,258,15.10,15
170318233031,878,560,318,36.20,36
170318233032,1331,1049,282,21.20,21
170318233033,644,489,155,24.10,24
170318233034,1003,1003,0,0.00,0
170318233035,826,668,158,19.10,19
170318233041,708,618,90,12.70,13
170318233042,786,781,5,0.60,1
170318233043,620,599,21,3.40,3
170318233044,1428,965,463,32.40,32
170318233045,1236,697,539,43.60,44
170318233046,1318,858,460,34.90,35
170318234001,1215,333,882,72.60,73
170318234002,1301,684,617,47.40,47
170318234003,772,367,405,52.50,53
170318234004,1776,871,905,51.00,51
170318235001,1341,802,539,40.20,40
170318235002,1526,431,1095,71.80,72
170318235003,1449,734,715,49.30,49
170318235004,580,501,79,13.60,14
170318236021,1385,1385,0,0.00,0
170318236022,1530,1361,169,11.00,11
170318236023,1953,1920,33,1.70,2
170318236024,1284,1196,88,6.90,7
170318236031,1382,219,1163,84.20,84
170318236032,1002,1002,0,0.00,0
170318236041,762,754,8,1.00,1
170318236042,967,967,0,0.00,0
170318236043,1858,1843,15,0.80,1
170318236051,2171,2090,81,3.70,4
170318236052,1151,1082,69,6.00,6
170318236053,946,832,114,12.10,12
170318237021,1643,1450,193,11.70,12
170318237022,2379,2257,122,5.10,5
170318237023,1761,1449,312,17.70,18
170318237024,1105,1090,15,1.40,1
170318237031,1731,1667,64,3.70,4
170318237032,1494,1428,66,4.40,4
170318237033,2387,2240,147,6.20,6
170318237034,1802,1099,703,39.00,39
170318237041,950,858,92,9.70,10
170318237042,2042,1640,402,19.70,20
170318237043,1195,1115,80,6.70,7
170318237051,1687,1330,357,21.20,21
170318237052,901,825,76,8.40,8
170318237053,809,792,17,2.10,2
170318237054,1452,1189,263,18.10,18
170318238011,2413,2306,107,4.40,4
170318238012,2103,2069,34,1.60,2
170318238013,878,878,0,0.00,0
170318238031,2429,2082,347,14.30,14
170318238032,1048,963,85,8.10,8
170318238033,2144,2032,112,5.20,5
170318238034,1390,1330,60,4.30,4
170318238051,982,941,41,4.20,4
170318238052,807,745,62,7.70,8
170318238053,1109,1062,47,4.20,4
170318238061,1174,922,252,21.50,22
170318238062,731,656,75,10.30,10
170318238063,738,715,23,3.10,3
170318238064,932,923,9,1.00,1
170318239011,2392,2292,100,4.20,4
170318239012,1459,1433,26,1.80,2
170318239031,1053,1028,25,2.40,2
170318239032,1145,760,385,33.60,34
170318239033,1202,1146,56,4.70,5
170318239034,1315,1315,0,0.00,0
170318239041,666,666,0,0.00,0
170318239042,817,808,9,1.10,1
170318239043,725,659,66,9.10,9
170318239044,1929,1776,153,7.90,8
170318240031,3407,3406,1,0.00,0
170318240032,1072,907,165,15.40,15
170318240033,1729,1537,192,11.10,11
170318240041,2473,2322,151,6.10,6
170318240042,1902,1864,38,2.00,2
170318240043,1132,1004,128,11.30,11
170318240051,1786,1753,33,1.80,2
170318240052,1976,1797,179,9.10,9
170318240053,1809,1515,294,16.30,16
170318240061,1689,1379,310,18.40,18
170318240062,2454,2387,67,2.70,3
170318241051,2166,2113,53,2.40,2
170318241052,3238,3066,172,5.30,5
170318241053,995,930,65,6.50,7
170318241061,1699,1568,131,7.70,8
170318241062,2699,2552,147,5.40,5
170318241063,2751,2545,206,7.50,8
170318241071,669,655,14,2.10,2
170318241072,1300,1075,225,17.30,17
170318241073,2273,1998,275,12.10,12
170318241074,2375,2243,132,5.60,6
170318241081,2804,2731,73,2.60,3
170318241082,2599,2420,179,6.90,7
170318241083,2281,1897,384,16.80,17
170318241131,1218,954,264,21.70,22
170318241132,2216,1939,277,12.50,13
170318241133,3732,3371,361,9.70,10
170318241141,3661,3521,140,3.80,4
170318241142,1280,1070,210,16.40,16
170318241151,1649,1498,151,9.20,9
170318241152,1953,1843,110,5.60,6
170318241161,1276,1056,220,17.20,17
170318241162,579,568,11,1.90,2
170318241163,2050,1674,376,18.30,18
170318241164,969,907,62,6.40,6
170318241171,2242,2114,128,5.70,6
170318241172,4100,3856,244,6.00,6
170318241173,2275,2038,237,10.40,10
170318241174,1266,1239,27,2.10,2
170318241191,2369,2288,81,3.40,3
170318241192,3631,3479,152,4.20,4
170318241201,2355,2355,0,0.00,0
170318241202,2146,2101,45,2.10,2
170318241203,1675,1616,59,3.50,4
170318241204,2436,2310,126,5.20,5
170318241211,1681,1664,17,1.00,1
170318241212,1616,1555,61,3.80,4
170318241221,1704,1676,28,1.60,2
170318241222,2740,2470,270,9.90,10
170318241223,1631,1560,71,4.40,4
170318241231,1232,1113,119,9.70,10
170318241232,2541,2093,448,17.60,18
170318241233,2384,2205,179,7.50,8
170318241234,1281,880,401,31.30,31
170318241235,1114,1025,89,8.00,8
170318243001,1333,1087,246,18.50,19
170318243002,2146,2124,22,1.00,1
170318243003,1406,1406,0,0.00,0
170318244001,2309,1994,315,13.60,14
170318245031,600,518,82,13.70,14
170318245032,1686,1571,115,6.80,7
170318245033,997,974,23,2.30,2
170318245034,2109,2059,50,2.40,2
170318245035,1210,1170,40,3.30,3
170318245051,3416,2802,614,18.00,18
170318245052,1367,1367,0,0.00,0
170318245053,2378,2082,296,12.40,12
170318245061,607,607,0,0.00,0
170318245062,976,976,0,0.00,0
170318245063,1795,1562,233,13.00,13
170318245064,1820,1731,89,4.90,5
170318245065,2657,2579,78,2.90,3
170318245071,2060,1708,352,17.10,17
170318245072,2389,2109,280,11.70,12
170318246011,991,864,127,12.80,13
170318246012,976,906,70,7.20,7
170318246013,969,952,17,1.80,2
170318246014,1869,1362,507,27.10,27
170318246021,1578,1433,145,9.20,9
170318246022,1795,1504,291,16.20,16
170318246023,1994,1512,482,24.20,24
170318246024,732,659,73,10.00,10
170318246025,739,623,116,15.70,16
170318247011,1743,1262,481,27.60,28
170318247012,1198,1036,162,13.50,14
170318247013,1008,756,252,25.00,25
170318247021,1162,1031,131,11.30,11
170318247022,2044,1318,726,35.50,36
170318247023,2444,1772,672,27.50,28
170318248001,2191,1012,1179,53.80,54
170318248002,2167,905,1262,58.20,58
170318248003,1910,1270,640,33.50,34
170318248004,1490,716,774,51.90,52
170318249001,1302,960,342,26.30,26
170318249002,1822,1739,83,4.60,5
170318250001,2140,1929,211,9.90,10
170318250002,895,784,111,12.40,12
170318250003,1898,1684,214,11.30,11
170318252001,603,598,5,0.80,1
170318252002,1259,894,365,29.00,29
170318253021,1832,1333,499,27.20,27
170318253022,1640,1547,93,5.70,6
170318253023,2153,1813,340,15.80,16
170318253031,1817,1167,650,35.80,36
170318253032,865,856,9,1.00,1
170318253033,550,550,0,0.00,0
170318253034,816,799,17,2.10,2
170318253041,1723,1625,98,5.70,6
170318253042,2203,2003,200,9.10,9
170318254001,1619,1520,99,6.10,6
170318254002,2106,1990,116,5.50,6
170318254003,1670,1259,411,24.60,25
170318255011,738,724,14,1.90,2
170318255012,2438,2362,76,3.10,3
170318255013,2547,2135,412,16.20,16
170318255031,376,170,206,54.80,55
170318255032,1088,1088,0,0.00,0
170318255033,1098,1065,33,3.00,3
170318255034,2404,2404,0,0.00,0
170318255035,2249,1914,335,14.90,15
170318255041,2210,2210,0,0.00,0
170318255042,1570,1533,37,2.40,2
170318255051,1563,1498,65,4.20,4
170318255052,1286,1286,0,0.00,0
170318255053,894,886,8,0.90,1
170318255054,1548,1509,39,2.50,3
170318256001,1140,1049,91,8.00,8
170318256002,2203,2057,146,6.60,7
170318256003,1496,1392,104,7.00,7
170318256004,773,467,306,39.60,40
170318257001,984,401,583,59.20,59
170318257002,2144,1881,263,12.30,12
170318257003,1097,1030,67,6.10,6
170318258011,740,740,0,0.00,0
170318258012,1771,1771,0,0.00,0
170318258013,1194,1159,35,2.90,3
170318258021,1837,1837,0,0.00,0
170318258022,1225,1204,21,1.70,2
170318258023,2172,1510,662,30.50,31
170318258031,1203,1060,143,11.90,12
170318258032,412,261,151,36.70,37
170318258033,1011,623,388,38.40,38
170318258034,919,919,0,0.00,0
170318258035,1481,1395,86,5.80,6
170318259001,1529,1296,233,15.20,15
170318259002,962,605,357,37.10,37
170318259003,1029,674,355,34.50,35
170318260001,1158,750,408,35.20,35
170318260002,1152,954,198,17.20,17
170318260003,1156,720,436,37.70,38
170318261001,607,589,18,3.00,3
170318261002,1006,925,81,8.10,8
170318261003,1292,991,301,23.30,23
170318261004,870,587,283,32.50,33
170318261005,1029,878,151,14.70,15
170318261006,2352,1881,471,20.00,20
170318262011,600,581,19,3.20,3
170318262012,885,789,96,10.80,11
170318262013,532,532,0,0.00,0
170318262014,1674,1665,9,0.50,1
170318262021,1062,925,137,12.90,13
170318262022,1119,1039,80,7.10,7
170318262023,1865,1511,354,19.00,19
170318262024,515,418,97,18.80,19
170318262025,1416,1351,65,4.60,5
170318263011,1405,1394,11,0.80,1
170318263012,1389,1354,35,2.50,3
170318263013,1371,1062,309,22.50,23
170318263031,763,763,0,0.00,0
170318263032,719,719,0,0.00,0
170318263033,935,935,0,0.00,0
170318263034,1843,1824,19,1.00,1
170318263041,697,683,14,2.00,2
170318263042,1084,1022,62,5.70,6
170318263043,1310,1252,58,4.40,4
170318264011,1802,1697,105,5.80,6
170318264012,2338,2167,171,7.30,7
170318264021,839,822,17,2.00,2
170318264022,889,836,53,6.00,6
170318264023,1274,1262,12,0.90,1
170318264024,1350,1285,65,4.80,5
170318264025,856,655,201,23.50,24
170318265001,2315,2308,7,0.30,0
170318265002,537,537,0,0.00,0
170318265003,1825,1779,46,2.50,3
170318265004,1792,1734,58,3.20,3
170318266001,1411,1411,0,0.00,0
170318266002,978,942,36,3.70,4
170318266003,1932,1866,66,3.40,3
170318266004,770,759,11,1.40,1
170318266005,935,935,0,0.00,0
170318267001,1585,1585,0,0.00,0
170318267002,1615,1615,0,0.00,0
170318267003,830,830,0,0.00,0
170318267004,1174,1156,18,1.50,2
170318268001,1047,1018,29,2.80,3
170318268002,2389,620,1769,74.00,74
170318268003,758,365,393,51.80,52
170318268004,573,493,80,14.00,14
170318269011,1579,1464,115,7.30,7
170318269021,635,635,0,0.00,0
170318269022,455,436,19,4.20,4
170318270001,1551,1551,0,0.00,0
170318270002,1074,735,339,31.60,32
170318270003,1110,1110,0,0.00,0
170318271001,509,495,14,2.80,3
170318271002,940,940,0,0.00,0
170318271003,1143,1103,40,3.50,4
170318272001,1499,1483,16,1.10,1
170318272002,835,809,26,3.10,3
170318272003,1000,926,74,7.40,7
170318272004,996,98,898,90.20,90
170318273001,222,201,21,9.50,10
170318273002,1821,1700,121,6.60,7
170318273003,1252,1202,50,4.00,4
170318274001,512,429,83,16.20,16
170318274002,1741,1649,92,5.30,5
170318274003,703,703,0,0.00,0
170318274004,1638,1634,4,0.20,0
170318275001,1291,881,410,31.80,32
170318275002,2753,1142,1611,58.50,59
170318275003,1324,1084,240,18.10,18
170318276001,917,917,0,0.00,0
170318276002,2142,2129,13,0.60,1
170318276003,486,486,0,0.00,0
170318277001,1655,1455,200,12.10,12
170318277002,1252,1240,12,1.00,1
170318278011,575,527,48,8.30,8
170318278012,822,762,60,7.30,7
170318278013,1115,1015,100,9.00,9
170318278014,2240,1983,257,11.50,12
170318278021,1813,1808,5,0.30,0
170318278022,1789,1753,36,2.00,2
170318278041,1477,1477,0,0.00,0
170318278042,624,624,0,0.00,0
170318278043,988,968,20,2.00,2
170318278051,1271,1246,25,2.00,2
170318278052,1323,1323,0,0.00,0
170318278053,498,498,0,0.00,0
170318279011,684,668,16,2.30,2
170318279012,1772,1707,65,3.70,4
170318279021,788,628,160,20.30,20
170318279022,1110,685,425,38.30,38
170318279023,879,765,114,13.00,13
170318279024,731,650,81,11.10,11
170318279025,934,790,144,15.40,15
170318280001,1266,1008,258,20.40,20
170318280002,962,595,367,38.10,38
170318280003,1544,1401,143,9.30,9
170318280004,1486,1167,319,21.50,22
170318281001,823,459,364,44.20,44
170318281002,1777,1665,112,6.30,6
170318281003,526,487,39,7.40,7
170318281004,931,797,134,14.40,14
170318281005,683,659,24,3.50,4
170318282011,2335,2249,86,3.70,4
170318282012,835,790,45,5.40,5
170318282013,1120,899,221,19.70,20
170318282021,1005,915,90,9.00,9
170318282022,1008,974,34,3.40,3
170318282023,1075,891,184,17.10,17
170318282024,1470,1418,52,3.50,4
170318283001,2165,1850,315,14.50,15
170318283002,1563,1408,155,9.90,10
170318284011,746,708,38,5.10,5
170318284012,1345,1104,241,17.90,18
170318284013,661,608,53,8.00,8
170318284014,929,874,55,5.90,6
170318284021,1335,1141,194,14.50,15
170318284022,1792,1531,261,14.60,15
170318284023,823,677,146,17.70,18
170318285031,1338,1152,186,13.90,14
170318285032,1479,1455,24,1.60,2
170318285033,582,582,0,0.00,0
170318285034,1382,1228,154,11.10,11
170318285041,2051,1882,169,8.20,8
170318285042,1312,1127,185,14.10,14
170318285043,1247,1101,146,11.70,12
170318285044,1252,1127,125,10.00,10
170318285051,929,929,0,0.00,0
170318285052,765,601,164,21.40,21
170318285053,809,708,101,12.50,13
170318285054,1226,1055,171,13.90,14
170318285055,2759,2437,322,11.70,12
170318285061,3553,3417,136,3.80,4
170318285062,1016,964,52,5.10,5
170318285063,1160,1136,24,2.10,2
170318285064,1373,1155,218,15.90,16
170318285065,834,311,523,62.70,63
170318285066,1316,1274,42,3.20,3
170318286011,715,648,67,9.40,9
170318286012,1021,984,37,3.60,4
170318286013,779,632,147,18.90,19
170318286014,1543,1461,82,5.30,5
170318286021,1909,1827,82,4.30,4
170318286022,2761,2670,91,3.30,3
170318287011,801,801,0,0.00,0
170318287012,1025,967,58,5.70,6
170318287013,964,788,176,18.30,18
170318287014,814,733,81,10.00,10
170318287021,1358,1283,75,5.50,6
170318287022,2069,1878,191,9.20,9
170318287023,1785,1670,115,6.40,6
170318288011,1068,1046,22,2.10,2
170318288012,693,659,34,4.90,5
170318288013,1980,1534,446,22.50,23
170318288014,653,562,91,13.90,14
170318288015,723,506,217,30.00,30
170318288021,1098,999,99,9.00,9
170318288022,1321,958,363,27.50,28
170318288023,1138,814,324,28.50,29
170318289001,1867,1233,634,34.00,34
170318289002,636,299,337,53.00,53
170318289003,991,482,509,51.40,51
170318290001,951,945,6,0.60,1
170318290002,530,523,7,1.30,1
170318291001,2193,480,1713,78.10,78
170318291002,1600,604,996,62.30,62
170318292001,1429,605,824,57.70,58
170318292002,1681,1161,520,30.90,31
170318292003,1833,881,952,51.90,52
170318292004,1200,664,536,44.70,45
170318293011,1455,1333,122,8.40,8
170318293012,2261,1994,267,11.80,12
170318293021,663,663,0,0.00,0
170318293022,1613,760,853,52.90,53
170318293023,1691,1359,332,19.60,20
170318294011,1544,1439,105,6.80,7
170318294021,1084,965,119,11.00,11
170318294022,1558,1531,27,1.70,2
170318294023,721,721,0,0.00,0
170318295001,2704,1438,1266,46.80,47
170318295002,598,496,102,17.10,17
170318295003,852,748,104,12.20,12
170318296001,1317,1149,168,12.80,13
170318296002,555,404,151,27.20,27
170318296003,1171,951,220,18.80,19
170318297001,1180,1180,0,0.00,0
170318297002,1262,1244,18,1.40,1
170318297003,1726,1669,57,3.30,3
170318298001,2199,2183,16,0.70,1
170318298002,902,818,84,9.30,9
170318298003,785,762,23,2.90,3
170318298004,1107,1107,0,0.00,0
170318298005,1550,1415,135,8.70,9
170318299011,2598,2598,0,0.00,0
170318299012,317,317,0,0.00,0
170318299013,1754,1149,605,34.50,35
170318299014,4467,4213,254,5.70,6
170318299021,940,940,0,0.00,0
170318299022,2032,2032,0,0.00,0
170318299023,2520,2421,99,3.90,4
170318299024,885,844,41,4.60,5
170318300011,2263,2062,201,8.90,9
170318300031,1718,1718,0,0.00,0
170318300032,2078,2048,30,1.40,1
170318300033,4156,3958,198,4.80,5
170318300041,1253,1253,0,0.00,0
170318300042,1351,1338,13,1.00,1
170318300043,4504,4354,150,3.30,3
170318300051,1964,1954,10,0.50,1
170318300052,2228,2198,30,1.30,1
170318300061,1371,1295,76,5.50,6
170318300062,892,841,51,5.70,6
170318300071,1435,1434,1,0.10,0
170318300072,1860,1808,52,2.80,3
170318300073,1270,1023,247,19.40,19
170318300081,2191,2111,80,3.70,4
170318300082,801,801,0,0.00,0
170318300083,1603,1580,23,1.40,1
170318301001,2268,1921,347,15.30,15
170318301002,1038,914,124,11.90,12
170318302011,1844,1844,0,0.00,0
170318302012,2829,2809,20,0.70,1
170318302013,1294,1294,0,0.00,0
170318302021,2294,2251,43,1.90,2
170318302022,1463,1415,48,3.30,3
170318303001,1645,1614,31,1.90,2
170318303002,1056,1019,37,3.50,4
170318303003,1172,1099,73,6.20,6
170318303004,870,770,100,11.50,12
170318304001,775,765,10,1.30,1
170318304002,560,496,64,11.40,11
170318304003,2199,1919,280,12.70,13
170318304004,825,790,35,4.20,4
170318305001,1360,24,1336,98.20,98
170318305002,1684,18,1666,98.90,99
170318305003,1262,71,1191,94.40,94
170318306001,965,673,292,30.30,30
170318306002,1854,1011,843,45.50,46
170318306003,962,509,453,47.10,47
170318306004,1073,400,673,62.70,63
170318307001,656,536,120,18.30,18
170318307002,710,679,31,4.40,4
170318307003,1323,1189,134,10.10,10
170318307004,872,650,222,25.50,26
170318308001,809,759,50,6.20,6
170318308002,520,479,41,7.90,8
170318308003,1171,1048,123,10.50,11
170318309001,1063,892,171,16.10,16
170318309002,886,551,335,37.80,38
170318309003,919,280,639,69.50,70
170318310001,892,882,10,1.10,1
170318310002,1434,1284,150,10.50,11
170318311001,1190,360,830,69.70,70
170318311002,1364,737,627,46.00,46
170318311003,1968,891,1077,54.70,55
170318311004,3121,1376,1745,55.90,56
170318312001,846,128,718,84.90,85
170318312002,2204,161,2043,92.70,93
170318312003,1967,118,1849,94.00,94
170318313001,1206,427,779,64.60,65
170318314001,503,503,0,0.00,0
170318314002,2278,1838,440,19.30,19
170318315001,2141,1137,1004,46.90,47
170318315002,1454,565,889,61.10,61
170318316001,1755,427,1328,75.70,76
170318316002,1088,405,683,62.80,63
170318316003,713,411,302,42.40,42
170318316004,1037,704,333,32.10,32
170318316005,1311,243,1068,81.50,82
170318316006,1018,258,760,74.70,75
170318317001,2313,1035,1278,55.30,55
170318318001,700,635,65,9.30,9
170318318002,1136,595,541,47.60,48
170318318003,1493,943,550,36.80,37
170318318004,1312,792,520,39.60,40
170318318005,1401,1232,169,12.10,12
170318319001,1503,1460,43,2.90,3
170318319002,1116,1047,69,6.20,6
170318320001,2181,1867,314,14.40,14
170318321001,1652,1561,91,5.50,6
170318321002,741,727,14,1.90,2
170318321003,859,767,92,10.70,11
170318322001,834,703,131,15.70,16
170318322002,1576,1297,279,17.70,18
170318322003,764,625,139,18.20,18
170318323001,1975,1692,283,14.30,14
170318324001,2061,1074,987,47.90,48
170318324002,1326,777,549,41.40,41
170318325001,1517,1269,248,16.30,16
170318325002,2257,2128,129,5.70,6
170318326001,1012,1000,12,1.20,1
170318326002,992,949,43,4.30,4
170318326003,2098,1903,195,9.30,9
170318329001,1608,1376,232,14.40,14
170318329002,739,631,108,14.60,15
170318330001,1457,1447,10,0.70,1
170318330002,1311,1258,53,4.00,4
170318331001,3211,3114,97,3.00,3
170318331002,1534,1302,232,15.10,15
170318331003,2672,2486,186,7.00,7
170318333001,2442,2090,352,14.40,14
170318339001,1190,638,552,46.40,46
170318339002,981,411,570,58.10,58
170318340001,2723,2676,47,1.70,2
170318340002,893,893,0,0.00,0
170318342001,889,889,0,0.00,0
170318342002,830,754,76,9.20,9
170318342003,1272,1272,0,0.00,0
170318342004,1307,1280,27,2.10,2
170318343001,982,982,0,0.00,0
170318343002,1433,1433,0,0.00,0
170318343003,411,410,1,0.20,0
170318343004,771,771,0,0.00,0
170318343005,1314,1314,0,0.00,0
170318343006,1471,1428,43,2.90,3
170318344001,858,858,0,0.00,0
170318344002,1823,1778,45,2.50,3
170318344003,1516,1507,9,0.60,1
170318345001,1563,1490,73,4.70,5
170318346001,88,88,0,0.00,0
170318346002,510,496,14,2.70,3
170318346003,906,906,0,0.00,0
170318346004,1506,1482,24,1.60,2
170318347001,485,485,0,0.00,0
170318347002,670,628,42,6.30,6
170318347003,893,808,85,9.50,10
170318348001,398,398,0,0.00,0
170318348002,579,579,0,0.00,0
170318348003,856,856,0,0.00,0
170318349001,836,836,0,0.00,0
170318349002,1456,1438,18,1.20,1
170318350001,864,737,127,14.70,15
170318350002,1091,1000,91,8.30,8
170318350003,1315,461,854,64.90,65
170318350004,1569,1138,431,27.50,28
170318350005,972,538,434,44.70,45
170318351001,1298,434,864,66.60,67
170318351002,1149,189,960,83.60,84
170318351003,1530,155,1375,89.90,90
170318351004,1578,95,1483,94.00,94
170318352001,1871,763,1108,59.20,59
170318355001,683,683,0,0.00,0
170318355002,910,724,186,20.40,20
170318356001,551,546,5,0.90,1
170318356002,399,399,0,0.00,0
170318357001,248,248,0,0.00,0
170318358001,1469,1437,32,2.20,2
170318359001,1492,1451,41,2.70,3
170318359002,983,983,0,0.00,0
170318359003,1120,1120,0,0.00,0
170318360001,850,850,0,0.00,0
170318360002,723,717,6,0.80,1
170318360003,1090,1042,48,4.40,4
170318361001,1038,905,133,12.80,13
170318361002,5,5,0,0.00,0
170318361003,790,790,0,0.00,0
170318362001,1590,1560,30,1.90,2
170318363001,723,706,17,2.40,2
170318363002,860,832,28,3.30,3
170318364001,767,750,17,2.20,2
170318364002,1419,1403,16,1.10,1
170318364003,1023,986,37,3.60,4
170318365001,1171,1119,52,4.40,4
170318365002,477,477,0,0.00,0
170318366001,1299,622,677,52.10,52
170318366002,1127,439,688,61.00,61
170318367001,1425,1095,330,23.20,23
170318367002,1173,873,300,25.60,26
170318368001,562,485,77,13.70,14
170318368002,1699,1699,0,0.00,0
170318369001,840,732,108,12.90,13
170318369002,713,713,0,0.00,0
170318370001,1265,1241,24,1.90,2
170318370002,1192,1102,90,7.60,8
170318371001,500,463,37,7.40,7
170318371002,1439,1318,121,8.40,8
170318373001,982,952,30,3.10,3
170318373002,1176,1086,90,7.70,8
170318374001,960,951,9,0.90,1
170318374002,1074,1068,6,0.60,1
170318378001,2035,1741,294,14.40,14
170318378002,1383,1346,37,2.70,3
170318380001,918,907,11,1.20,1
170318380002,1943,1742,201,10.30,10
170318381001,1139,1092,47,4.10,4
170318381002,313,279,34,10.90,11
170318381003,385,367,18,4.70,5
170318382001,1189,928,261,22.00,22
170318382002,677,587,90,13.30,13
170318383001,916,751,165,18.00,18
170318383002,590,525,65,11.00,11
170318386001,578,578,0,0.00,0
170318386002,826,805,21,2.50,3
170318387001,2235,2153,82,3.70,4
170318387002,851,727,124,14.60,15
170318387003,1100,1004,96,8.70,9
170318387004,705,705,0,0.00,0
170318388001,790,155,635,80.40,80
170318388002,2442,1689,753,30.80,31
170318390001,2817,2728,89,3.20,3
170318390002,2694,2577,117,4.30,4
170318390003,1159,1087,72,6.20,6
170318390004,1198,1180,18,1.50,2
170318391001,3233,2980,253,7.80,8
170318391002,2033,1834,199,9.80,10
170318392001,244,244,0,0.00,0
170318392002,1277,1228,49,3.80,4
170318392003,670,661,9,1.30,1
170318395001,1379,1341,38,2.80,3
170318396001,748,748,0,0.00,0
170318396002,1083,1073,10,0.90,1
170318397001,1258,736,522,41.50,42
170318397002,1518,795,723,47.60,48
170318397003,2018,840,1178,58.40,58
170318398001,693,508,185,26.70,27
170318398002,1114,751,363,32.60,33
170318398003,846,672,174,20.60,21
170318399001,638,493,145,22.70,23
170318399002,1028,713,315,30.60,31
170318399003,666,577,89,13.40,13
170318399004,731,635,96,13.10,13
170318399005,744,531,213,28.60,29
170318400001,1901,1627,274,14.40,14
170318400002,749,628,121,16.20,16
170318401001,722,663,59,8.20,8
170318401002,1624,1375,249,15.30,15
170318402001,2589,1894,695,26.80,27
170318403001,583,188,395,67.80,68
170318403002,1034,608,426,41.20,41
170318403003,2530,803,1727,68.30,68
170318404001,1318,895,423,32.10,32
170318404002,1954,1081,873,44.70,45
170318407001,451,38,413,91.60,92
170318407002,1680,187,1493,88.90,89
170318407003,1939,198,1741,89.80,90
170318408001,1964,28,1936,98.60,99
170318408002,1455,56,1399,96.20,96
170318410001,683,683,0,0.00,0
170318411001,1905,1905,0,0.00,0
170318411002,2428,2428,0,0.00,0
170318411003,1911,1874,37,1.90,2
170318411004,1378,1378,0,0.00,0
170318412001,1606,179,1427,88.90,89
170318412002,1918,250,1668,87.00,87
170318412003,2161,331,1830,84.70,85
170318413001,1139,197,942,82.70,83
170318413002,1392,129,1263,90.70,91
170318413003,992,232,760,76.60,77
170318413004,698,78,620,88.80,89
170318414001,722,642,80,11.10,11
170318414002,587,527,60,10.20,10
170318415001,1457,1339,118,8.10,8
170318415002,1215,1190,25,2.10,2
170318416001,817,817,0,0.00,0
170318417001,1613,982,631,39.10,39
170318418001,609,607,2,0.30,0
170318418002,2037,1900,137,6.70,7
170318419001,2459,2167,292,11.90,12
170318419002,3315,2732,583,17.60,18
170318420001,958,936,22,2.30,2
170318420002,2059,1888,171,8.30,8
170318421001,1739,857,882,50.70,51
170318421002,1173,769,404,34.40,34
170318421003,580,562,18,3.10,3
170318421004,1387,549,838,60.40,60
170318421005,900,708,192,21.30,21
170318421006,794,521,273,34.40,34
170318422001,2344,2054,290,12.40,12
170318423001,1366,1158,208,15.20,15
170318423002,2133,2112,21,1.00,1
170318424001,1070,1070,0,0.00,0
170318424002,1502,1502,0,0.00,0
170318424003,802,802,0,0.00,0
170318425001,2375,2371,4,0.20,0
170318426001,1530,1036,494,32.30,32
170318426002,810,281,529,65.30,65
170318426003,1209,1093,116,9.60,10
170318426004,1439,785,654,45.40,45
170318428001,869,54,815,93.80,94
170318428002,1358,92,1266,93.20,93
170318428003,1146,290,856,74.70,75
170318428004,1431,104,1327,92.70,93
170318428005,1997,331,1666,83.40,83
170318428006,837,21,816,97.50,98
170318429001,413,362,51,12.30,12
170318429002,272,239,33,12.10,12
170318429003,1257,1189,68,5.40,5
170318429004,304,119,185,60.90,61
170318430001,1704,1698,6,0.40,0
170318430002,1434,1373,61,4.30,4
170318431001,1672,1604,68,4.10,4
170318431002,601,568,33,5.50,6
170318432001,1463,194,1269,86.70,87
170318432002,1262,194,1068,84.60,85
170318433001,1772,1056,716,40.40,40
170318434001,1460,1413,47,3.20,3
170318435001,8881,6874,2007,22.60,23
170318436001,1216,1207,9,0.70,1
170318436002,1393,1350,43,3.10,3
170318437001,1049,939,110,10.50,11
170318437002,1230,930,300,24.40,24
170318438001,878,572,306,34.90,35
170318438002,978,871,107,10.90,11
170318439001,638,618,20,3.10,3
170318439002,356,347,9,2.50,3
170318439003,947,804,143,15.10,15
170318439004,1035,999,36,3.50,4
170318439005,652,652,0,0.00,0
170319800001,0,0,0,0.00,0
170319801001,0,0,0,0.00,0
170319900000,0,0,0,0.00,0